2,6,0,0,0,0,0,0,0,0,0,0,0,0,0,0,0,0,0,0,0,0,0,0,0,0,6,2,
2,6,0,0,8,7,7,7,7,7,7,7,7,0,7,7,7,7,7,7,7,7,7,8,0,0,6,2,
2,2,2,2,2,2,2,2,2,2,2,2,2,6,2,2,2,2,2,2,2,2,2,2,2,2,2,2,
0,0,0,0,0,0,7,0,7,0,0,0,0,6,0,0,0,0,0,7,0,0,7,0,0,0,0,0,
0,0,0,0,2,3,2,2,2,2,0,0,0,6,0,0,0,2,3,2,2,2,2,2,0,0,0,0,
0,0,0,0,0,3,7,0,7,0,0,0,0,6,0,0,0,0,3,7,0,0,7,0,0,0,0,0,
0,0,0,2,2,2,2,2,2,3,2,0,0,6,0,0,2,2,2,2,2,2,2,3,2,0,0,0,
0,0,0,0,0,0,7,0,7,3,0,0,0,6,0,0,0,0,0,7,0,0,7,3,0,0,0,0,
0,0,2,3,2,2,2,2,2,2,2,2,0,6,0,2,3,2,2,2,2,2,2,2,2,2,0,0,
0,0,0,3,0,0,7,0,7,0,0,0,0,6,0,0,3,0,0,7,0,0,7,0,0,0,0,0,
0,2,2,2,2,2,2,2,2,2,2,3,2,6,2,2,2,2,2,2,2,2,2,2,2,3,2,0,
0,0,0,0,0,0,7,0,0,7,0,3,0,6,0,0,0,0,7,0,0,0,7,0,0,3,0,0,
0,2,3,2,2,2,2,2,2,2,2,2,2,6,2,2,2,2,2,2,2,2,2,2,2,2,2,0,
0,0,3,0,0,0,0,0,0,0,0,0,0,0,0,0,0,0,0,0,0,0,0,0,0,0,0,0,
0,0,3,0,0,0,7,0,0,7,0,0,0,0,0,0,0,0,7,0,0,0,7,0,0,0,0,8,
1,1,1,1,1,1,1,1,1,1,1,1,1,1,1,1,1,1,1,1,1,1,1,1,1,1,1,1,
