0,4,0,0,0,0,0,0,0,0,0,0,0,0,0,0,0,0,0,0,0,0,0,0,0,0,4,0,
3,0,1,1,1,1,1,1,1,1,1,1,1,1,1,1,1,1,1,1,1,1,1,1,1,1,0,3,
3,0,1,0,0,0,0,1,0,0,7,0,0,7,1,0,0,0,0,0,0,0,1,0,0,1,0,3,
3,0,1,0,7,0,0,1,1,1,1,5,1,1,1,0,0,0,0,0,0,0,1,0,0,1,0,3,
3,0,1,5,1,1,1,1,0,0,0,0,0,1,0,7,8,0,7,0,0,0,1,0,7,1,0,3,
3,0,1,0,0,0,1,0,0,0,0,0,0,1,1,1,1,1,1,1,1,1,1,1,1,1,0,3,
3,0,1,0,7,0,1,0,0,0,0,0,0,1,0,0,0,0,0,0,1,0,0,0,0,1,0,3,
3,0,1,1,1,1,1,0,0,7,0,8,0,1,0,0,0,0,0,0,1,0,0,0,0,1,0,3,
3,0,1,0,0,0,1,1,1,1,1,1,1,1,1,0,0,0,0,0,1,0,0,7,0,1,0,3,
3,0,1,0,0,0,0,0,0,1,0,0,0,0,1,7,0,0,8,0,1,1,5,1,1,1,0,3,
3,0,1,0,7,0,0,7,0,1,0,0,0,0,1,1,1,1,1,1,1,0,0,0,0,1,0,3,
3,0,1,1,1,5,1,1,1,1,0,0,0,0,1,0,0,0,1,0,0,0,0,0,0,1,0,3,
3,0,1,0,7,0,1,7,0,0,0,8,7,0,1,7,0,0,1,0,7,0,0,0,0,1,0,3,
3,0,1,1,1,5,1,1,1,1,1,1,1,1,1,1,5,1,1,1,1,1,1,5,1,1,0,3,
3,0,0,0,0,0,0,0,0,0,0,0,9,0,0,0,0,0,0,8,0,0,0,0,0,0,0,3,
1,1,1,1,1,1,1,1,1,1,1,1,1,1,1,1,1,1,1,1,1,1,1,1,1,1,1,1,
