0,0,0,0,0,0,0,0,0,0,0,0,0,0,0,0,0,0,0,0,0,0,0,0,0,0,0,0,
0,0,0,0,0,6,6,6,6,6,6,6,6,9,6,0,0,0,0,0,0,0,6,0,0,0,0,0,
0,0,0,0,8,0,0,0,0,6,0,0,0,0,6,6,0,0,0,0,0,6,6,8,2,0,0,0,
0,0,7,3,7,0,0,0,0,6,0,0,0,0,0,6,6,0,0,0,6,6,0,2,2,2,0,0,
0,7,3,3,3,7,0,0,0,6,0,0,0,0,0,0,6,6,0,6,6,0,2,2,2,2,2,0,
7,3,3,3,3,3,7,0,0,6,0,0,0,0,0,0,0,6,6,6,0,2,2,2,2,2,2,2,
3,3,3,3,3,3,3,4,4,6,0,0,7,8,0,7,0,0,6,4,4,4,4,3,3,3,0,0,
0,0,0,3,0,0,0,0,1,1,1,1,1,1,1,1,1,1,1,1,0,0,0,0,3,0,0,0,
0,0,7,2,7,0,0,0,1,0,7,0,0,0,0,0,0,7,0,1,0,0,0,0,3,0,0,0,
0,7,2,2,2,7,0,0,1,0,4,4,4,4,4,4,4,4,0,1,0,0,0,0,3,0,0,0,
0,2,2,2,2,2,0,0,1,0,3,0,0,0,0,0,0,3,0,1,0,0,0,0,3,0,0,0,
0,0,2,2,2,0,0,0,1,0,3,0,0,0,0,0,0,3,0,1,0,0,0,0,3,0,0,0,
3,1,1,1,1,1,3,0,1,7,3,0,0,0,8,0,0,3,7,1,0,0,0,0,3,0,0,0,
3,0,0,0,0,0,3,0,1,1,1,1,1,1,1,1,1,1,1,1,0,0,0,0,3,0,0,0,
3,0,0,0,0,0,3,0,0,3,0,0,0,0,0,0,0,0,3,0,0,0,0,0,3,0,0,0,
3,1,1,1,1,1,3,3,1,1,1,1,1,1,1,1,1,1,1,1,3,3,1,1,1,1,1,3,
