4,4,4,4,4,4,4,4,4,4,0,0,0,0,0,0,0,0,4,4,4,4,4,4,4,4,4,4,
3,0,0,0,0,0,0,0,0,0,1,1,1,1,1,1,1,1,0,0,0,0,0,0,0,0,0,3,
3,0,0,0,0,0,0,0,1,1,1,1,1,1,1,1,1,1,1,1,0,0,0,0,0,0,0,3,
3,0,0,0,8,0,0,1,1,1,1,1,1,1,1,1,1,1,1,1,1,0,0,8,0,0,0,3,
3,0,2,2,2,2,1,1,1,1,1,1,1,1,1,1,1,1,1,1,1,1,2,2,2,2,0,3,
3,0,0,0,0,0,0,0,0,1,1,1,1,1,1,1,1,1,1,0,0,0,0,0,0,0,0,3,
3,0,2,3,0,0,0,0,0,0,0,0,1,1,1,1,0,0,0,0,0,0,0,0,3,2,0,3,
2,2,2,3,0,0,0,0,0,0,0,0,0,0,0,0,0,0,0,0,0,0,0,0,3,2,2,2,
0,0,0,3,0,0,7,0,0,7,0,0,7,0,0,7,0,0,7,0,0,7,0,0,3,0,0,0,
0,0,0,3,0,0,0,0,0,0,0,0,0,0,0,0,0,0,0,0,0,0,0,0,3,0,0,0,
0,0,0,3,0,0,0,0,0,0,0,0,1,1,1,1,0,0,0,0,0,0,0,0,3,0,0,0,
0,0,0,3,0,0,0,0,0,1,1,1,5,5,5,5,1,1,1,0,0,9,0,0,3,0,0,0,
0,0,0,3,0,0,1,1,1,5,5,5,5,5,5,5,5,5,5,1,1,1,0,0,3,0,0,0,
0,0,0,3,0,0,0,5,5,5,5,5,5,5,5,5,5,5,5,5,5,0,0,0,3,0,0,0,
0,0,0,3,0,0,0,0,5,5,5,5,5,5,5,5,5,5,5,5,0,0,0,0,3,0,0,0,
0,0,0,3,0,0,0,0,0,0,5,5,5,5,5,5,5,5,0,0,0,0,0,0,3,0,0,0,
