0,0,0,0,0,0,0,0,0,0,0,6,0,0,0,0,6,0,0,0,0,0,0,0,0,0,0,0,
0,0,0,0,0,0,0,0,0,0,0,6,0,0,0,0,6,0,0,0,0,0,0,0,0,0,0,0,
0,0,0,7,0,8,0,0,0,3,1,6,0,0,0,0,6,1,3,0,0,0,8,0,7,0,0,0,
3,1,1,1,1,1,3,4,4,3,1,6,0,0,0,0,6,1,3,4,4,3,1,1,1,1,1,3,
3,1,0,0,0,1,3,0,0,0,1,6,0,0,0,0,6,1,0,0,0,3,1,0,0,0,1,3,
3,1,0,0,0,1,3,0,0,0,1,6,0,0,0,0,6,1,0,0,0,3,1,0,0,0,1,3,
3,1,0,7,0,1,3,0,0,0,1,6,0,0,0,0,6,1,0,0,0,3,1,0,7,0,1,3,
3,1,1,1,1,1,3,0,0,0,1,6,0,0,0,0,6,1,0,0,0,3,1,1,1,1,1,3,
3,1,0,0,0,1,3,0,0,0,1,6,0,0,0,0,6,1,0,0,0,3,1,0,0,0,1,3,
3,1,0,0,0,1,3,4,4,4,1,3,1,1,1,1,3,1,4,4,4,3,1,0,0,0,1,3,
3,1,0,0,0,1,0,0,0,3,1,3,0,0,0,0,3,1,3,0,0,0,1,0,0,0,1,3,
3,1,8,7,0,1,0,0,0,3,1,3,0,0,7,8,3,1,3,0,0,0,1,0,7,8,1,3,
3,1,1,5,1,1,0,0,0,3,1,1,2,2,2,2,2,1,3,0,0,0,1,1,5,1,1,3,
3,0,0,0,0,0,5,0,0,3,0,0,0,0,0,0,0,0,3,0,0,5,0,0,0,0,0,3,
3,0,0,0,0,0,0,5,8,3,0,0,0,0,9,0,0,0,3,0,5,0,0,0,0,0,0,3,
1,1,1,1,1,1,1,1,1,1,1,1,1,1,1,1,1,1,1,1,1,1,1,1,1,1,1,1,
