0,0,0,0,0,0,0,0,0,0,0,0,0,6,0,0,0,0,0,0,0,0,0,0,0,0,0,0,
4,4,4,4,4,4,4,4,4,4,4,0,0,6,0,0,0,0,0,0,0,0,0,0,0,0,0,0,
0,0,7,0,0,0,0,7,0,2,3,0,0,6,0,7,0,0,0,0,0,0,0,0,0,0,0,0,
1,1,1,1,1,1,1,1,2,2,2,2,2,2,2,2,3,0,0,7,3,2,3,0,0,0,0,0,
1,2,1,2,1,2,1,2,2,2,2,2,0,0,0,2,2,2,2,2,2,2,3,0,0,0,0,0,
0,0,0,0,0,0,0,0,0,0,2,2,0,0,7,0,0,0,0,0,0,2,3,0,8,7,0,0,
4,4,4,4,4,4,4,4,3,0,2,2,1,1,1,1,1,3,0,0,0,2,2,1,1,1,1,3,
0,0,0,0,0,0,0,0,3,0,2,2,0,0,0,0,0,3,8,0,0,0,0,1,1,1,1,3,
0,0,0,0,0,0,0,0,3,0,2,2,0,1,1,1,1,1,1,1,1,3,0,1,1,1,1,3,
0,7,0,0,0,0,7,0,3,0,2,2,0,1,0,0,0,0,0,0,1,3,0,1,1,1,1,3,
1,1,1,8,0,0,1,0,3,0,2,2,0,1,0,0,0,7,0,0,1,3,0,1,1,7,1,3,
1,1,1,1,1,1,1,0,3,0,2,2,0,1,1,1,1,1,1,1,1,3,0,1,1,0,1,3,
0,0,0,0,0,0,0,0,3,0,0,0,0,1,0,0,7,0,0,0,1,3,0,0,0,0,1,3,
1,1,1,1,1,1,1,1,1,1,1,1,1,1,0,3,1,1,3,0,1,1,1,1,1,1,1,3,
0,0,0,0,0,0,0,0,0,0,9,0,0,0,0,3,0,7,3,0,0,0,0,0,0,0,0,3,
1,1,1,1,1,1,1,1,1,1,1,1,1,1,1,1,1,1,1,1,1,1,1,1,1,1,1,1,
