0,0,0,0,0,0,0,0,0,0,0,0,1,1,1,0,0,0,0,0,0,0,0,0,0,0,0,6,
0,0,0,0,7,0,0,8,0,7,0,0,2,2,2,0,0,0,0,0,7,8,0,0,7,0,0,6,
3,1,1,1,1,1,1,1,1,1,1,1,1,1,1,3,1,1,1,1,1,1,1,1,1,1,1,1,
3,4,4,4,4,4,4,4,4,4,4,0,2,2,2,3,0,0,0,0,0,0,0,0,0,0,0,0,
0,0,0,0,0,0,0,0,0,0,0,3,1,1,1,3,0,0,4,4,4,4,4,4,4,4,4,0,
0,4,4,4,4,4,4,4,4,4,4,3,2,2,2,3,7,0,0,0,0,0,0,0,0,0,0,3,
3,0,7,0,0,4,4,4,4,9,0,0,1,1,1,1,1,1,0,0,0,0,0,0,0,7,3,1,
1,1,1,1,1,0,0,0,0,1,3,0,2,2,2,2,2,2,0,0,0,0,8,7,3,1,1,1,
0,0,4,0,1,0,0,0,0,1,3,0,1,1,1,1,1,1,0,0,0,7,3,1,1,1,1,1,
1,1,7,3,1,0,0,0,0,1,3,0,2,2,2,2,2,2,0,7,3,1,1,1,1,1,1,1,
7,1,1,3,1,0,0,0,0,1,3,4,4,4,4,4,0,7,3,1,1,1,1,1,1,1,1,1,
1,1,7,3,1,0,0,0,0,1,3,0,2,2,2,0,3,2,2,2,2,2,2,2,2,2,2,2,
7,1,1,3,1,0,7,7,0,1,3,0,1,1,1,0,3,0,0,0,0,0,0,0,0,0,0,0,
1,1,7,3,1,1,1,1,5,1,3,0,2,2,2,0,3,1,1,1,1,1,1,1,1,1,1,3,
7,1,1,3,0,0,8,0,0,0,3,7,1,1,1,7,3,1,7,0,0,0,0,0,0,0,0,3,
1,1,1,1,1,1,1,1,1,1,1,1,2,2,2,1,1,1,2,2,2,2,2,2,2,2,2,2,
