6,0,0,0,0,0,0,0,0,0,0,0,0,0,0,0,0,0,0,0,0,0,0,0,0,0,0,0,
6,0,0,0,0,0,0,0,0,0,0,0,0,0,0,0,0,0,0,0,0,0,0,0,0,0,0,0,
1,1,1,1,1,1,1,1,1,1,1,1,1,1,1,3,1,1,0,7,0,0,0,0,0,0,9,0,
0,0,0,0,0,0,0,0,0,0,8,0,0,0,0,3,1,1,5,1,2,2,2,2,2,2,2,3,
7,0,0,3,3,3,3,3,3,3,3,3,3,3,0,3,0,0,0,0,0,0,0,0,0,0,0,3,
1,7,0,3,0,0,3,3,3,3,3,3,3,3,0,3,0,7,0,7,0,3,1,1,1,1,1,3,
0,1,7,3,0,0,3,0,0,0,0,0,0,0,0,3,0,1,6,1,0,1,1,1,1,1,1,3,
0,0,1,3,0,0,3,7,0,7,0,7,0,7,0,0,3,0,1,0,0,0,0,0,0,0,0,3,
0,0,0,1,7,0,3,1,5,1,5,1,5,1,0,3,0,0,0,0,0,8,7,0,7,0,7,3,
0,0,0,0,1,0,3,0,0,0,0,0,0,0,0,0,3,0,0,0,0,1,3,1,1,1,1,3,
0,0,0,0,0,0,3,0,3,0,3,0,3,0,0,3,0,0,0,0,0,0,3,0,0,0,0,0,
0,0,0,0,0,0,3,0,0,0,0,0,0,0,0,0,3,0,0,0,0,0,3,0,8,0,0,0,
0,0,0,0,0,0,0,3,0,3,0,3,0,0,0,3,0,0,0,0,0,0,1,1,1,1,1,3,
0,0,0,0,0,0,0,0,3,0,3,0,3,0,0,0,3,0,0,0,0,0,0,0,0,0,0,3,
0,0,0,0,8,0,0,0,0,7,6,1,0,0,0,3,0,0,0,8,0,0,0,0,0,0,0,3,
1,1,1,1,1,1,1,1,1,1,1,1,1,1,1,1,1,1,1,1,1,1,1,1,1,1,1,1,
