0,0,0,0,0,0,0,0,0,0,0,0,0,0,0,0,0,0,0,0,0,0,0,0,6,0,0,0,
0,0,0,0,0,0,0,0,0,0,0,0,0,0,0,7,0,0,0,0,0,1,8,1,6,1,0,0,
0,0,0,0,0,0,3,4,4,4,3,1,1,1,1,1,1,1,1,1,1,1,0,1,6,1,0,0,
7,0,4,4,4,4,3,0,0,0,0,1,0,0,0,0,0,0,7,0,0,1,0,1,6,1,0,0,
1,3,0,0,0,0,0,0,0,0,0,1,0,0,0,0,1,1,1,1,1,1,0,1,6,1,0,0,
1,1,3,0,0,0,0,0,0,8,0,1,0,0,0,0,7,0,0,0,0,0,0,1,6,1,0,0,
1,1,1,3,0,0,0,0,0,7,0,1,0,0,0,0,0,4,4,4,4,4,0,1,6,1,0,0,
1,1,1,1,3,0,4,4,4,4,4,1,7,0,0,7,1,0,0,0,0,3,0,0,6,0,0,0,
2,2,2,2,2,2,3,0,0,0,0,1,1,1,1,1,1,0,0,0,0,3,4,4,6,0,0,0,
0,0,0,0,0,0,3,0,0,0,0,1,1,1,1,1,1,0,0,0,0,3,0,1,1,1,1,1,
0,0,0,0,0,0,3,0,0,0,0,1,1,1,1,1,1,0,0,0,0,3,0,1,7,0,8,0,
0,0,0,0,0,0,3,0,0,0,0,1,1,1,1,1,1,0,0,0,0,3,0,1,1,1,1,3,
0,0,0,0,0,0,3,0,0,0,0,0,0,0,0,0,0,0,0,0,0,3,0,0,0,0,0,3,
0,0,0,0,4,4,3,0,0,0,0,0,0,0,0,0,0,0,0,0,0,3,0,0,0,0,0,3,
8,0,7,1,0,0,3,0,0,0,0,0,0,0,9,0,0,0,0,0,0,3,0,0,0,0,0,3,
1,1,1,1,0,0,3,1,1,7,1,1,1,1,1,1,1,1,1,1,1,3,0,0,1,1,1,3,
