6,0,0,0,0,0,0,0,0,0,0,0,0,0,0,0,0,0,0,0,0,0,0,0,0,0,0,6,
6,0,0,0,0,0,0,0,0,0,0,0,0,0,0,0,0,0,0,0,0,0,0,0,0,0,0,6,
6,0,0,0,0,0,0,0,0,0,8,0,0,0,0,0,0,0,0,0,0,0,0,0,0,0,0,6,
3,1,1,1,5,1,1,1,1,1,1,1,1,1,1,1,1,1,1,1,1,1,1,1,1,1,1,3,
3,1,1,1,5,1,1,1,1,1,1,1,1,1,1,1,1,1,1,1,1,1,1,1,1,1,1,3,
3,0,0,0,7,0,0,0,1,1,4,4,4,4,4,4,4,4,1,1,0,0,0,0,0,0,0,3,
3,0,0,0,0,0,0,0,7,1,3,0,0,0,0,8,7,7,1,1,0,0,0,0,8,0,0,3,
3,0,0,1,1,1,0,0,1,1,3,0,1,1,1,1,1,1,1,1,0,0,1,1,1,1,1,3,
3,0,0,1,7,1,0,0,1,1,3,0,0,0,0,0,0,0,1,1,0,0,1,1,7,1,1,3,
3,0,0,0,9,0,0,0,1,1,3,0,0,0,0,0,0,0,1,1,0,0,1,1,1,1,1,3,
3,0,0,1,1,1,0,0,1,1,1,1,1,1,1,1,3,3,1,1,0,0,1,1,7,1,1,3,
3,0,0,1,1,1,0,0,1,1,1,1,1,1,1,1,3,3,1,1,0,0,1,1,1,1,1,3,
3,0,0,1,1,1,0,8,1,1,0,0,0,0,0,0,3,0,1,1,0,0,0,0,0,0,0,3,
3,0,0,1,1,1,0,0,1,1,0,0,0,0,0,7,3,0,1,1,0,0,0,0,7,0,0,3,
1,1,1,1,1,1,1,1,1,1,3,1,1,1,1,1,1,1,1,1,3,1,1,1,1,1,1,1,
1,1,1,1,1,1,1,0,7,0,3,1,1,1,1,1,1,0,7,0,3,1,1,1,1,1,1,1,
