4,4,4,4,4,4,4,4,4,4,4,4,4,4,4,4,0,0,0,0,0,0,0,0,0,0,0,0,
0,0,0,0,0,7,0,0,0,0,0,0,0,0,0,0,3,8,0,0,0,0,0,0,0,0,0,0,
0,0,0,0,7,7,7,0,0,0,0,0,0,0,0,3,3,3,0,0,0,0,0,0,0,0,0,0,
0,0,0,0,7,7,7,0,0,0,0,0,0,0,0,3,3,3,0,0,0,0,0,0,0,0,0,0,
0,0,0,7,7,0,0,0,0,0,0,0,0,0,3,3,0,0,0,0,0,0,0,0,0,0,0,0,
0,7,7,0,7,7,7,0,0,0,0,0,3,3,0,3,3,3,0,0,4,4,4,4,4,4,4,4,
7,7,0,7,7,0,0,7,7,0,0,3,3,0,3,3,0,0,3,3,0,0,0,8,0,0,0,0,
0,0,0,3,3,0,0,0,0,0,0,0,0,0,3,3,0,0,0,0,0,0,3,3,3,3,3,0,
0,8,0,3,3,3,0,0,0,0,0,0,0,0,3,3,3,0,0,0,0,0,7,7,7,7,7,0,
3,3,3,3,0,3,3,0,0,0,0,3,3,3,3,0,3,3,0,0,0,0,3,3,3,3,3,0,
0,0,0,0,0,3,3,0,0,0,0,0,0,0,0,0,3,3,0,0,0,0,7,7,7,7,7,0,
0,0,0,0,0,3,3,0,0,0,0,0,0,0,9,0,3,3,0,0,0,0,3,3,3,3,3,0,
1,1,1,1,1,1,1,1,1,1,1,1,3,1,1,1,1,1,1,1,1,1,1,1,1,1,1,1,
0,0,0,0,0,0,0,0,0,0,0,0,3,0,0,0,0,0,0,0,0,0,0,0,0,0,0,0,
0,0,0,0,0,0,0,0,0,0,0,0,3,0,0,0,0,0,0,0,0,0,0,0,0,0,0,0,
1,1,1,1,1,1,1,1,1,1,1,1,1,1,1,1,1,1,1,1,1,1,1,1,1,1,1,1,
