6,0,0,0,0,0,0,0,0,0,0,0,0,0,0,0,0,0,0,0,0,0,0,0,0,0,0,6,
6,0,0,0,0,0,0,9,0,0,0,0,0,0,0,0,0,0,0,0,8,0,0,0,0,0,0,6,
6,0,0,0,2,1,3,1,2,4,4,4,4,4,4,4,4,4,4,2,1,3,1,2,0,0,0,6,
6,0,0,0,2,7,3,0,2,0,7,0,0,0,0,0,0,7,0,2,0,3,0,2,0,0,0,6,
6,0,2,1,1,0,3,0,1,1,2,0,0,0,0,0,0,2,1,1,0,3,7,1,1,2,0,6,
6,6,2,7,0,0,3,0,0,7,2,0,7,0,0,0,7,2,0,7,0,3,0,1,0,2,6,6,
2,6,1,1,1,0,3,0,0,0,1,1,2,0,0,2,1,1,1,1,1,3,0,1,0,1,6,2,
2,0,0,0,0,0,3,0,0,0,0,0,2,0,7,2,7,0,0,0,0,3,0,1,0,0,7,2,
2,0,0,0,0,0,3,1,1,1,1,1,2,3,1,2,1,1,0,0,7,3,0,1,1,0,1,2,
2,0,7,0,8,0,3,0,0,0,8,0,0,3,0,0,0,0,0,1,1,3,0,0,0,0,0,2,
2,3,1,1,1,1,3,0,0,0,2,1,1,3,1,1,1,2,0,0,0,3,0,0,0,1,3,2,
0,3,2,0,7,0,3,0,0,0,1,0,0,3,0,7,0,1,0,0,0,3,0,0,8,2,3,0,
0,3,2,1,1,0,3,0,1,1,1,0,0,3,0,0,0,1,1,1,0,3,0,1,1,2,3,0,
0,3,0,7,2,0,3,0,2,0,0,0,0,3,0,0,0,0,7,2,0,3,0,2,0,0,3,0,
0,3,0,0,0,1,1,1,0,0,0,0,0,3,9,0,0,0,0,0,1,1,1,0,0,0,3,0,
1,1,1,1,1,1,1,1,1,1,1,1,1,1,1,1,1,1,1,1,1,1,1,1,1,1,1,1,
