1,1,1,1,1,6,1,1,1,1,1,1,1,1,1,1,1,1,1,1,1,1,1,1,1,1,1,1,
0,0,0,0,1,6,1,0,4,4,4,4,4,4,4,0,0,0,0,0,0,0,0,0,0,0,0,1,
6,1,1,6,0,6,1,0,1,7,0,0,0,1,3,1,0,0,0,0,0,0,0,0,0,8,0,1,
6,0,1,1,1,1,1,0,1,1,1,1,1,1,3,1,1,1,1,1,7,0,1,3,1,1,1,1,
1,6,0,0,0,0,7,4,4,4,1,1,1,1,3,1,1,1,1,1,1,1,1,3,1,0,1,1,
1,1,1,1,1,1,1,0,0,0,1,0,0,1,3,1,1,1,0,1,1,1,1,3,1,0,1,1,
0,0,0,0,0,0,0,0,0,0,0,0,0,1,3,1,1,1,0,1,1,0,1,3,1,7,0,1,
3,1,1,1,1,1,1,1,3,1,3,7,0,1,3,1,1,1,0,1,1,0,1,3,1,1,1,1,
3,0,0,0,0,0,0,0,3,1,1,1,1,1,3,1,1,1,7,0,1,0,1,3,1,1,0,1,
3,0,0,0,0,0,0,0,0,0,1,1,1,1,3,1,1,1,1,1,1,0,1,3,1,1,7,1,
3,0,0,0,0,0,0,0,1,0,0,0,0,0,3,0,0,0,0,0,0,0,0,3,0,0,0,1,
3,1,1,1,3,1,1,1,1,3,1,2,1,2,1,2,1,2,1,2,1,2,1,3,1,2,1,2,
3,1,1,1,3,1,1,1,1,3,1,1,1,1,1,1,0,0,1,1,1,1,1,3,1,2,1,2,
3,0,0,0,3,0,0,0,0,3,1,1,1,1,1,1,1,0,0,1,1,1,1,3,0,0,0,0,
3,1,1,1,1,1,1,1,1,3,1,1,1,1,1,1,1,1,7,0,1,1,1,1,1,1,1,3,
3,9,0,0,0,0,0,0,0,3,0,7,0,1,1,1,1,1,1,0,0,8,0,0,0,0,0,3,
