0,0,0,0,0,0,0,0,0,0,0,0,7,0,0,0,0,0,0,0,0,0,0,0,0,0,0,0,
0,4,4,4,4,4,4,4,0,1,1,1,1,3,9,0,0,0,0,0,0,0,0,0,0,0,0,0,
3,0,0,0,0,0,0,0,0,0,0,7,0,3,0,0,0,0,7,0,0,0,0,0,0,7,0,0,
3,0,0,0,0,0,0,0,0,3,2,2,2,2,0,1,1,1,1,1,1,1,3,1,1,1,1,1,
3,0,0,0,0,0,0,0,0,3,0,7,0,0,0,0,0,0,0,0,0,0,3,0,0,0,0,0,
3,1,1,1,1,1,1,3,0,1,1,1,1,3,0,0,0,0,0,0,0,0,3,0,0,0,0,0,
3,0,0,0,0,0,0,3,0,0,0,7,0,3,8,3,1,1,1,1,1,1,1,1,1,1,1,3,
3,0,0,0,0,0,0,3,0,3,2,2,2,2,0,3,2,2,2,2,2,2,2,2,2,2,2,3,
3,0,0,0,0,7,3,1,0,3,7,0,0,0,0,3,2,0,0,0,0,0,7,0,0,0,2,3,
3,0,0,0,0,3,1,0,0,1,1,1,1,3,0,3,2,3,2,2,2,2,2,2,2,3,2,3,
3,0,0,7,3,1,0,0,0,0,0,0,7,3,0,3,2,3,2,0,0,0,7,0,0,3,2,3,
3,0,0,3,1,0,0,0,0,3,2,2,2,2,0,3,2,3,2,2,2,2,2,2,2,2,2,3,
3,0,3,1,0,0,0,0,0,3,0,7,0,0,0,3,2,3,0,0,0,0,7,0,0,0,0,3,
3,3,1,0,0,0,0,0,0,1,1,1,1,3,0,3,2,2,2,2,2,2,2,2,2,2,2,2,
3,3,0,0,8,0,0,0,0,0,0,0,0,6,0,3,0,0,0,0,8,0,0,0,0,0,0,0,
1,1,1,1,1,1,1,1,1,1,1,1,1,1,1,1,1,1,1,1,1,1,1,1,1,1,1,1,
