0,0,0,0,0,0,0,0,0,0,0,0,3,1,1,3,0,0,0,0,0,0,0,0,0,0,0,0,
0,0,0,0,0,0,0,0,0,0,8,7,3,1,1,3,7,8,0,0,0,0,0,0,0,0,0,0,
0,0,0,0,0,0,0,0,0,0,3,1,1,1,1,1,1,3,0,0,0,0,0,0,0,0,0,0,
0,0,0,0,0,0,0,0,0,7,3,1,1,1,1,1,1,3,7,0,0,0,0,0,0,0,0,0,
0,0,0,0,0,0,0,0,3,1,1,1,1,1,1,1,1,1,1,3,0,0,0,0,0,0,0,0,
0,0,0,0,0,0,8,7,3,1,1,1,1,1,1,1,1,1,1,3,7,8,0,0,0,0,0,0,
0,0,0,0,0,0,3,1,1,1,1,1,1,1,1,1,1,1,1,1,1,3,0,0,0,0,0,0,
0,0,0,0,0,7,3,0,0,0,7,7,7,7,7,7,7,7,0,0,0,3,7,0,0,0,0,0,
0,0,0,0,3,1,1,1,1,1,1,1,1,1,1,1,1,1,1,1,1,1,1,3,0,0,0,0,
0,0,0,7,3,1,1,1,1,1,1,1,1,1,1,1,1,1,1,1,1,1,1,3,7,0,0,0,
0,0,3,1,1,1,1,1,1,1,1,1,1,1,1,1,1,1,1,1,1,1,1,1,1,3,0,0,
0,0,3,1,1,1,1,1,1,1,1,1,1,1,1,1,1,1,1,1,1,1,1,1,1,3,0,0,
0,0,3,0,0,0,0,0,0,0,0,0,0,0,0,0,0,0,0,0,0,0,0,0,0,3,0,0,
0,0,3,0,0,0,0,0,0,0,0,0,0,0,0,0,0,0,0,0,0,0,0,0,0,3,0,0,
0,0,3,0,0,0,0,0,0,0,0,0,0,9,0,0,0,0,0,0,0,0,0,0,0,3,0,0,
1,1,1,1,1,1,1,1,1,1,1,1,1,1,1,1,1,1,1,1,1,1,1,1,1,1,1,1,
