0,0,0,0,0,6,0,0,0,0,0,0,0,0,0,0,0,0,0,0,0,0,0,0,0,0,0,0,
0,0,0,0,0,6,0,0,0,0,0,0,0,0,0,0,0,2,2,2,2,2,2,2,2,2,2,2,
2,2,2,2,2,6,2,2,2,2,2,3,4,4,4,4,3,0,0,0,0,0,0,0,0,0,0,2,
2,0,0,0,0,6,0,0,0,0,0,3,0,9,0,0,3,0,0,0,8,0,0,0,0,0,0,2,
1,1,1,1,1,3,1,1,1,1,1,1,1,1,1,1,1,1,1,1,1,1,1,1,1,1,1,1,
1,1,3,0,0,3,0,0,3,1,1,1,0,0,0,0,1,1,1,1,0,0,0,0,0,0,1,1,
1,3,3,1,1,1,1,1,3,1,1,1,0,1,1,0,1,1,1,1,1,1,1,1,1,1,1,1,
1,3,1,1,1,1,1,1,0,3,1,1,0,7,1,0,1,1,1,0,1,1,0,0,1,1,0,1,
1,3,1,0,1,1,1,0,1,3,1,1,0,1,1,0,1,1,1,0,7,1,1,1,0,7,0,1,
1,3,1,1,0,7,0,1,1,3,1,1,0,0,0,0,1,1,1,0,1,1,0,7,1,1,0,1,
1,3,1,1,1,1,1,1,1,3,1,1,1,1,1,1,1,1,1,5,1,1,1,1,1,1,1,1,
1,3,0,0,1,0,1,7,0,3,3,0,0,0,0,0,0,0,0,0,0,0,0,0,0,8,3,1,
1,3,1,1,1,1,1,1,1,0,3,1,1,1,1,1,1,1,1,3,1,1,1,1,1,1,3,1,
1,3,0,7,1,1,1,0,0,0,3,0,0,0,0,0,0,1,1,3,0,0,0,0,0,0,3,1,
1,3,0,0,0,0,0,0,8,0,3,0,0,0,7,0,0,1,1,3,0,0,0,7,0,0,3,1,
1,1,1,1,1,1,1,1,1,1,1,1,1,1,1,1,1,1,1,1,1,1,1,1,1,1,1,1,
