6,0,0,0,0,0,0,0,0,0,0,0,0,0,0,0,0,0,0,0,0,0,0,0,0,0,0,6,
6,0,0,0,0,0,0,0,0,0,0,0,0,0,0,0,0,0,0,0,0,0,0,0,0,0,0,6,
1,1,1,1,1,1,3,1,1,1,1,3,8,0,8,3,1,1,1,1,3,1,1,1,1,1,1,1,
0,4,0,0,0,0,3,0,0,0,0,3,2,3,2,3,0,0,0,0,3,0,0,0,0,0,4,0,
3,0,1,1,1,1,1,0,0,0,0,0,0,3,0,0,0,7,0,0,1,1,1,1,1,1,0,3,
3,0,1,1,1,1,1,0,0,1,3,3,3,3,3,3,3,1,0,0,1,1,1,1,1,1,0,3,
3,0,1,1,1,7,1,0,0,1,3,2,2,2,2,2,3,1,0,0,1,1,7,1,1,1,0,3,
3,0,1,1,1,1,1,0,0,1,3,3,3,3,3,3,3,1,0,0,1,1,1,1,1,1,0,3,
3,0,0,0,0,0,0,0,0,0,4,4,4,4,4,4,4,0,0,0,0,0,0,0,0,0,0,3,
3,0,8,0,0,0,3,0,0,0,0,0,0,2,0,0,0,0,0,0,3,0,0,0,0,8,0,3,
3,2,2,2,2,2,3,0,0,0,0,7,2,2,2,7,0,0,0,0,3,2,2,2,2,2,2,3,
3,0,0,0,0,0,3,0,0,0,0,2,2,2,2,2,0,0,0,0,3,0,0,0,0,0,0,3,
3,1,1,1,1,1,3,0,0,0,2,2,2,2,2,2,2,0,0,0,3,1,1,1,1,1,1,3,
3,0,0,0,0,0,3,0,7,2,2,2,2,2,2,2,2,2,7,0,3,0,0,0,0,0,0,3,
3,2,2,2,2,2,3,0,2,2,2,2,2,2,2,2,2,2,2,0,3,2,2,2,2,2,2,3,
7,0,0,0,0,0,3,2,2,2,2,2,2,2,2,2,2,2,2,2,3,0,0,9,0,0,0,7,
