0,0,6,0,0,0,0,0,0,0,0,0,0,0,0,0,0,0,0,0,0,0,0,0,0,0,6,0,
0,0,3,1,1,1,1,1,1,1,1,1,1,1,1,1,1,1,1,1,1,1,1,1,1,1,3,0,
0,0,3,0,3,1,1,0,0,0,7,0,0,0,7,0,8,0,7,0,0,0,1,1,3,0,3,0,
0,0,3,1,1,1,3,1,1,1,1,1,1,1,1,1,1,1,1,1,1,1,3,1,3,1,3,0,
0,0,3,0,3,0,3,0,1,1,1,0,7,0,0,0,7,8,1,1,3,0,0,0,3,0,3,0,
0,0,1,1,3,1,1,1,3,0,3,1,1,1,1,1,1,1,3,0,3,1,1,1,3,1,3,0,
0,0,3,0,3,0,3,0,3,0,3,0,3,1,1,1,3,0,3,0,3,0,3,0,3,0,3,0,
0,0,3,1,1,1,3,1,1,1,3,0,3,0,7,0,3,0,3,1,1,1,3,1,1,1,3,0,
7,0,3,0,3,0,3,0,3,0,3,8,3,2,2,2,3,8,3,0,3,0,3,0,3,0,3,7,
1,1,1,1,3,1,1,1,3,7,3,2,3,2,2,2,3,2,3,7,3,1,1,1,3,1,1,1,
1,1,3,0,3,0,3,0,3,2,3,2,3,2,2,2,3,2,3,2,3,0,3,0,3,0,3,1,
1,1,3,1,1,0,3,2,3,2,3,2,3,2,2,2,3,2,3,2,3,2,3,0,1,1,3,1,
1,1,3,0,3,2,3,2,3,2,3,2,3,2,2,2,3,2,3,2,3,2,3,2,3,0,3,1,
1,1,3,2,3,0,3,0,3,0,3,0,3,0,0,9,3,0,3,0,3,0,3,0,3,2,3,1,
1,1,1,1,1,1,1,1,1,1,1,1,3,1,7,1,3,1,1,1,1,1,1,1,1,1,1,1,
1,1,1,1,1,1,1,1,1,1,1,1,1,1,1,1,1,1,1,1,1,1,1,1,1,1,1,1,
