0,0,0,7,0,0,0,0,0,0,4,0,4,0,0,8,0,0,0,4,0,0,0,0,0,0,4,8,
3,1,1,1,0,3,1,1,1,1,7,1,7,1,1,1,1,1,3,0,4,0,0,0,0,4,0,3,
3,0,0,7,0,3,1,1,1,1,1,1,1,1,1,1,1,1,3,0,4,7,0,4,0,7,0,3,
3,1,1,1,0,3,1,1,7,1,1,1,1,1,7,1,1,1,3,4,0,0,4,0,4,0,4,3,
3,0,0,7,0,3,1,1,1,1,1,1,1,1,1,1,1,1,3,0,7,0,0,0,7,0,0,3,
3,1,1,1,0,3,1,7,1,1,1,1,1,1,1,7,1,1,3,0,4,4,0,0,4,0,0,3,
3,0,0,7,0,3,1,1,1,1,1,1,1,1,1,1,1,1,3,0,4,0,7,0,4,7,4,3,
3,1,1,1,0,3,1,1,7,1,1,1,1,1,7,1,1,1,3,0,0,0,4,0,0,4,0,3,
3,0,0,7,0,3,1,1,1,1,1,1,1,1,1,1,1,1,3,0,0,4,0,4,0,0,0,3,
3,1,1,1,0,3,1,1,1,7,1,1,1,7,1,1,1,1,3,4,0,0,4,0,4,0,4,3,
3,0,0,7,0,3,1,1,1,1,1,1,1,1,1,1,1,1,3,0,0,7,0,0,0,4,0,3,
3,1,1,1,0,3,1,1,1,1,7,1,7,1,1,1,1,1,3,0,0,0,4,4,0,7,0,3,
3,0,0,7,0,3,1,1,1,1,1,1,1,1,1,1,1,1,3,0,4,0,0,4,0,4,0,3,
3,1,1,1,0,3,1,1,1,7,1,1,1,7,1,1,1,1,3,0,7,0,4,0,4,0,4,3,
3,0,8,0,0,3,1,1,1,1,1,1,1,1,1,1,1,1,3,0,0,0,0,0,9,0,0,0,
3,1,1,1,1,3,1,1,7,1,1,1,1,1,7,1,1,1,3,1,1,1,1,1,1,1,1,1,
