0,0,0,0,0,0,0,3,0,0,0,0,0,0,0,0,0,0,0,0,0,0,0,0,0,0,0,0,
0,8,7,0,0,0,0,3,0,0,0,0,0,0,0,0,0,0,0,0,0,0,0,0,0,7,8,0,
3,1,1,8,7,0,0,3,0,0,0,0,0,0,0,0,0,0,0,0,0,0,0,7,8,1,1,3,
3,0,0,1,1,0,0,3,1,1,1,1,6,3,1,1,1,1,1,3,0,0,0,1,1,0,0,3,
3,0,0,0,0,0,0,0,0,0,0,0,3,3,7,0,0,0,0,3,0,0,0,0,0,0,0,3,
3,0,0,0,0,0,0,0,0,0,0,0,7,3,3,0,0,0,0,3,0,0,0,0,0,0,0,3,
3,0,0,0,0,0,0,0,0,0,0,0,3,3,7,0,0,0,0,0,0,0,0,0,0,0,0,3,
3,0,0,0,0,0,0,0,0,0,0,0,7,3,3,0,0,0,0,0,0,0,0,0,0,0,0,3,
3,0,0,0,0,0,0,0,0,0,0,0,3,3,7,0,0,0,0,0,0,0,0,0,0,0,0,3,
3,0,0,0,0,0,0,0,0,0,0,0,7,3,3,0,0,0,0,0,0,0,0,0,0,0,0,3,
3,0,0,0,0,0,0,0,0,0,0,0,3,3,7,0,0,0,0,0,0,0,0,0,0,0,0,3,
3,0,0,0,0,0,0,0,0,0,0,0,7,3,3,0,0,0,0,0,0,0,0,0,0,0,0,3,
3,0,0,0,0,0,0,0,0,0,0,0,3,3,7,0,0,0,0,0,0,0,0,0,0,0,0,3,
3,0,0,0,0,0,0,0,0,0,0,0,7,3,3,0,0,0,0,0,0,0,0,0,0,0,0,3,
3,0,0,0,0,0,0,0,9,0,0,0,3,3,7,0,0,0,0,0,0,0,0,0,0,0,0,3,
3,0,0,0,0,3,1,1,1,1,1,1,1,1,1,1,1,1,1,1,1,1,3,0,0,0,0,3,
