0,0,0,0,0,0,0,0,0,0,0,0,0,0,0,0,0,0,0,0,0,0,0,0,0,0,0,0,
0,0,0,0,0,4,4,4,6,0,0,0,0,0,0,4,4,4,0,0,0,0,4,0,0,0,4,4,
3,0,0,0,3,0,0,4,1,2,2,2,2,2,2,0,0,0,1,1,1,1,0,2,2,3,0,0,
3,7,0,0,3,7,0,0,1,0,0,0,2,7,0,0,0,0,0,0,0,0,0,0,0,3,0,7,
1,1,3,4,2,2,3,0,2,3,0,0,2,2,1,2,0,5,5,5,5,1,1,0,3,1,5,1,
0,7,3,0,8,7,3,0,2,3,0,0,2,7,0,0,0,0,0,0,0,0,0,0,3,0,0,0,
3,1,1,4,3,2,2,0,2,3,3,0,2,2,1,3,0,5,0,0,0,0,5,0,3,0,0,0,
3,7,0,0,3,7,0,0,2,0,3,3,0,0,2,3,0,0,1,7,7,1,0,0,3,0,0,0,
1,1,3,4,2,2,3,0,2,0,0,3,3,0,2,3,0,0,0,1,1,3,4,4,3,0,7,0,
8,7,3,0,0,7,3,0,2,0,0,0,3,3,2,3,0,0,0,0,0,3,0,0,1,1,5,1,
3,1,1,4,3,2,2,0,2,0,0,0,0,3,2,3,0,0,8,0,0,3,0,0,0,0,0,0,
3,7,0,0,3,7,8,0,2,0,0,0,0,0,2,3,2,2,2,2,2,2,2,2,3,0,7,0,
1,1,3,4,2,2,3,0,2,0,0,0,0,0,2,3,1,0,0,7,0,7,0,1,3,1,5,1,
0,7,3,0,0,7,3,0,2,0,0,0,0,0,2,3,1,3,1,2,1,2,1,1,3,0,0,0,
3,1,1,4,2,2,2,0,2,8,7,7,3,1,0,3,1,3,0,7,0,7,0,3,3,0,0,0,
3,0,9,0,0,0,0,0,1,1,1,1,1,1,2,2,1,1,2,1,2,1,2,1,2,1,2,1,
