7,7,7,4,4,4,4,7,7,7,0,7,7,7,4,4,4,4,4,4,4,4,4,4,4,7,7,7,
1,1,1,0,0,0,0,1,1,1,3,1,1,1,0,0,0,0,0,0,0,0,0,0,0,1,1,1,
1,1,1,0,0,0,0,1,1,1,3,1,1,1,0,0,0,0,0,0,0,0,0,0,0,1,1,1,
1,1,1,0,0,0,0,1,1,1,3,1,1,1,0,0,0,0,7,7,7,0,0,0,0,1,1,1,
1,1,1,0,0,0,0,1,1,1,3,1,1,1,0,0,0,0,1,1,1,0,0,0,0,1,1,1,
1,1,1,0,0,0,0,1,1,1,3,1,1,1,0,0,0,0,1,1,1,0,0,0,0,1,1,1,
1,1,1,0,0,0,0,1,1,1,3,1,1,1,0,0,0,0,1,1,1,0,0,0,0,1,1,1,
1,1,1,0,0,0,0,1,1,1,3,1,1,1,0,0,0,0,1,1,1,0,0,0,0,1,1,1,
1,1,1,0,0,0,0,1,1,1,3,1,1,1,0,0,0,0,1,1,1,0,0,0,0,1,1,1,
1,1,1,7,4,4,7,1,1,1,3,1,1,1,7,4,4,7,1,1,1,7,4,4,7,1,1,1,
1,1,1,1,7,7,1,1,1,1,3,1,1,1,1,7,7,1,1,1,1,1,7,7,1,1,1,1,
1,1,1,1,1,1,1,1,1,1,3,1,1,1,1,1,1,1,1,1,1,1,1,1,1,1,1,1,
0,1,1,1,1,1,1,1,1,0,3,0,1,1,1,1,1,1,1,0,1,1,1,1,1,1,1,0,
0,0,1,1,1,1,1,1,0,0,3,0,0,1,1,1,1,1,0,0,0,1,1,1,1,1,0,0,
0,0,0,8,0,0,0,0,0,9,3,0,0,0,0,0,0,0,0,0,0,8,0,0,0,0,0,0,
1,1,1,1,1,1,1,1,1,1,1,1,1,1,1,1,1,1,1,1,1,1,1,1,1,1,1,1,
