0,0,0,0,0,0,0,0,0,0,0,0,0,0,0,0,0,0,3,0,0,0,6,0,0,0,0,0,
0,0,0,0,0,0,0,0,4,4,0,0,0,0,0,0,0,0,3,0,0,0,6,0,0,0,0,0,
7,0,0,0,7,0,0,4,4,0,3,0,0,0,0,0,4,4,3,0,0,7,6,8,0,0,0,0,
1,1,1,1,3,4,4,0,0,0,3,0,8,0,0,4,4,4,1,5,1,1,3,1,3,0,0,0,
0,0,0,0,3,0,0,2,1,5,1,3,0,0,4,4,4,7,1,7,0,0,6,1,3,0,0,0,
5,5,1,1,1,3,0,0,7,0,0,3,4,3,2,2,0,2,1,1,1,1,1,1,3,0,0,0,
5,7,0,0,0,3,0,0,2,0,0,0,0,3,0,0,0,2,2,2,2,0,4,4,3,0,0,0,
0,5,7,0,0,3,0,0,0,0,0,0,7,3,0,7,0,0,0,0,0,3,2,0,0,0,0,0,
0,0,1,7,0,3,1,5,1,1,3,2,2,2,2,2,2,3,1,5,2,3,2,0,0,0,0,0,
0,0,3,1,7,3,0,0,0,0,3,0,0,7,0,0,0,3,0,0,0,3,2,0,0,0,0,0,
0,0,3,0,5,3,2,0,0,0,3,1,5,1,1,1,1,3,1,1,2,3,2,0,0,0,0,0,
0,0,3,0,4,3,0,0,7,0,3,0,0,7,0,0,0,3,0,0,2,3,2,0,0,0,0,0,
0,0,3,2,0,7,0,0,2,0,3,1,1,1,1,5,1,3,0,2,7,3,7,2,0,0,0,0,
0,0,3,0,0,2,0,0,0,0,3,0,0,7,0,0,0,3,0,2,2,3,2,2,0,0,0,0,
0,0,3,0,0,0,0,0,0,0,3,1,1,5,1,1,1,3,0,0,8,3,0,0,0,0,0,0,
1,1,1,1,1,1,1,1,1,1,3,0,0,8,0,0,9,3,1,1,1,1,1,1,1,1,1,1,
