0,4,4,4,4,4,4,4,4,4,4,0,0,9,0,0,0,4,4,4,4,4,4,4,4,4,4,0,
3,0,0,0,0,4,4,4,4,0,0,1,1,1,1,1,1,0,0,4,4,4,4,0,0,0,0,3,
3,0,0,0,0,4,4,4,0,1,1,1,1,1,1,1,1,1,1,0,4,4,4,0,0,0,0,3,
3,0,0,0,0,4,4,0,1,1,1,1,1,1,1,1,1,1,1,1,0,4,4,0,0,0,0,3,
3,0,0,0,0,4,0,1,1,1,1,1,7,7,7,7,1,1,1,1,1,0,4,0,0,0,0,3,
3,0,0,0,0,4,0,1,1,1,1,1,1,1,1,1,1,1,1,1,1,0,4,0,0,0,0,3,
3,0,0,0,0,0,1,1,1,1,1,1,1,1,1,1,1,1,1,1,1,1,0,0,0,0,0,3,
3,0,0,0,0,0,1,1,7,7,7,7,1,1,1,1,7,7,7,7,1,1,0,0,0,0,0,3,
3,0,0,0,0,0,1,1,1,1,1,1,1,1,1,1,1,1,1,1,1,1,0,0,0,0,0,3,
3,0,0,0,0,0,1,1,1,1,1,1,7,7,7,7,1,1,1,1,1,1,0,0,0,0,0,3,
3,0,0,0,0,0,0,1,1,1,1,1,1,1,1,1,1,1,1,1,1,0,0,0,0,0,0,3,
3,0,0,0,0,4,0,1,1,1,1,1,1,1,1,1,1,1,1,1,1,0,4,0,0,0,0,3,
3,0,0,0,0,4,0,0,1,7,7,7,7,1,1,7,7,7,7,1,0,0,4,0,0,0,0,3,
3,0,0,0,0,4,4,0,0,1,1,1,1,1,1,1,1,1,1,0,0,4,4,0,0,0,0,3,
3,8,7,7,7,4,4,4,7,0,0,1,1,1,1,1,1,0,0,7,4,4,4,7,7,7,8,3,
1,1,1,1,1,1,1,1,1,3,7,7,7,7,7,7,7,7,3,1,1,1,1,1,1,1,1,1,
