0,0,0,0,0,0,0,0,0,0,0,0,0,0,0,0,0,0,0,0,0,0,0,0,0,0,0,6,
0,0,0,0,0,0,0,0,0,0,0,0,0,0,0,0,0,0,0,0,0,0,0,0,0,0,0,6,
0,0,0,0,0,0,0,0,0,0,0,0,0,0,0,0,0,0,0,0,0,8,4,7,7,7,4,6,
0,0,7,4,7,4,0,0,0,0,0,0,0,0,0,0,0,0,0,0,0,3,7,1,1,1,7,3,
7,3,1,0,1,0,7,4,0,0,0,0,0,0,0,0,0,0,0,0,7,3,1,1,1,1,1,3,
1,3,0,0,0,0,1,0,0,0,0,0,0,0,0,0,0,0,7,0,1,3,1,1,7,1,1,3,
0,3,0,0,0,0,0,0,7,4,0,0,0,0,0,0,0,0,1,3,4,3,1,1,1,1,1,3,
0,3,0,0,0,0,0,0,1,0,0,0,0,0,0,0,7,0,4,3,0,0,7,1,1,1,7,0,
0,3,0,0,0,0,0,0,0,0,0,0,0,0,0,0,1,3,0,0,0,0,0,0,0,0,0,0,
0,3,0,0,0,0,0,0,0,0,7,0,0,0,0,0,0,3,0,0,0,0,7,7,7,7,0,0,
0,3,0,0,0,0,0,0,0,0,1,0,0,0,7,0,4,3,0,0,0,7,1,1,1,1,7,0,
0,3,0,0,0,0,0,0,0,0,0,0,0,0,1,3,0,0,0,0,0,1,1,1,1,3,5,0,
0,3,0,0,0,0,0,0,0,0,0,7,4,0,0,3,0,0,0,0,0,1,1,1,3,5,1,0,
0,3,0,0,0,0,0,0,0,0,0,1,0,7,4,3,0,0,0,0,0,1,1,3,5,1,1,0,
0,3,0,0,0,0,0,0,0,0,0,0,7,1,0,3,0,0,0,0,0,1,3,5,1,1,1,0,
0,3,0,0,9,0,0,0,0,0,0,0,1,0,0,3,0,8,0,0,0,3,5,1,1,1,1,0,
