0,0,0,0,0,0,0,0,0,7,0,0,0,7,0,0,0,0,0,0,0,0,0,0,0,0,0,0,
0,7,0,0,0,7,0,0,0,1,1,3,1,1,0,0,0,7,0,0,0,7,0,0,0,0,7,0,
0,1,1,3,1,1,0,0,0,0,0,3,0,0,0,0,0,1,1,3,1,1,0,0,0,1,3,1,
0,0,0,3,0,0,0,0,0,0,3,0,0,0,0,0,0,0,0,3,0,0,0,0,0,0,3,0,
0,0,0,0,3,0,0,0,0,0,0,3,0,0,0,0,0,0,0,0,3,0,0,0,0,3,0,0,
0,0,0,3,0,0,0,0,0,0,0,8,3,0,0,0,7,7,0,0,0,3,0,0,0,0,3,0,
0,0,3,0,0,0,0,0,0,0,0,3,0,0,0,0,1,1,0,0,3,0,4,4,4,4,0,3,
0,0,0,3,0,0,0,0,0,0,3,0,0,0,0,0,0,0,0,3,0,0,0,0,0,0,3,0,
0,0,0,0,3,0,0,0,0,0,0,3,0,4,4,4,4,4,4,0,3,0,0,0,0,3,9,0,
0,0,0,3,0,4,4,4,4,4,0,8,3,0,0,0,0,0,0,0,0,3,0,0,0,0,1,1,
0,0,3,0,0,0,7,7,0,0,0,3,0,0,0,0,0,0,0,0,3,0,0,0,0,0,0,0,
0,0,0,3,0,0,1,1,0,0,3,0,0,0,0,0,0,0,0,3,0,0,0,0,0,0,0,0,
0,0,8,0,3,0,0,0,0,0,0,3,0,0,0,0,0,0,0,0,3,0,8,0,0,0,0,0,
1,1,1,1,1,5,5,5,5,5,5,5,5,5,5,5,5,5,5,5,1,1,1,1,1,1,1,3,
0,0,0,0,0,0,0,0,0,0,0,0,0,0,0,0,0,0,0,0,0,0,0,0,0,0,0,3,
1,1,1,1,1,1,1,1,1,1,1,1,1,1,1,1,1,1,1,1,1,1,1,1,1,1,1,1,
