1,1,1,1,1,1,1,1,1,1,1,1,1,1,1,1,1,1,1,1,1,1,1,1,1,1,1,6,
1,0,0,0,3,3,3,3,3,3,3,3,3,3,3,3,3,3,3,3,3,3,3,0,0,0,1,6,
1,0,9,0,3,0,3,3,3,0,0,0,0,3,0,0,0,3,3,0,0,0,3,0,8,0,1,6,
1,1,1,1,3,0,3,3,3,0,3,3,0,3,0,3,3,0,3,0,3,3,3,1,1,1,1,6,
1,0,0,0,3,0,3,3,3,0,3,3,0,3,0,3,3,0,3,0,0,0,3,0,0,0,1,6,
1,0,8,0,3,0,3,3,3,0,3,3,0,3,0,3,3,0,3,0,3,3,3,0,8,0,1,6,
1,1,1,1,3,0,0,0,3,0,0,0,0,3,0,0,0,3,3,0,0,0,3,1,1,1,1,6,
3,3,3,3,3,3,3,3,3,3,3,3,3,3,3,3,3,3,3,3,3,3,3,3,3,3,3,6,
3,0,7,0,3,0,7,0,3,0,7,0,0,3,0,0,7,0,3,0,7,0,3,0,7,0,3,6,
3,3,3,3,3,3,3,3,3,3,3,3,3,3,3,3,3,3,3,3,3,3,3,3,3,3,3,6,
3,0,0,0,3,0,3,0,3,0,3,3,0,3,0,3,3,0,3,0,0,0,3,0,0,0,3,6,
3,0,3,0,3,0,3,0,3,0,0,3,0,3,0,0,3,0,3,0,3,3,3,0,3,0,3,6,
3,0,0,3,3,0,3,0,3,0,3,0,0,3,0,3,0,0,3,0,0,0,3,0,0,3,3,6,
3,0,3,0,3,0,3,0,3,0,3,3,0,3,0,3,3,0,3,0,3,3,3,0,3,0,3,6,
3,0,3,0,3,0,0,0,3,0,3,3,0,3,0,3,3,0,3,0,0,0,3,0,3,0,3,6,
3,3,3,3,3,3,3,3,3,3,3,3,3,3,3,3,3,3,3,3,3,3,3,3,3,3,3,6,
