2,2,2,2,2,2,2,2,2,2,2,2,2,2,2,2,2,2,2,2,2,2,6,0,0,0,0,2,
2,0,0,0,0,0,0,0,0,0,8,0,0,0,0,0,0,0,0,0,0,0,6,0,0,0,0,2,
2,0,0,0,0,3,1,2,1,1,2,2,1,3,2,0,0,0,0,0,0,0,6,0,0,0,0,2,
2,0,0,0,0,3,0,0,0,0,0,0,6,3,2,1,2,1,1,2,2,1,6,0,0,0,0,2,
2,0,1,1,2,3,0,0,0,0,0,3,6,3,1,0,1,0,8,1,4,4,4,4,4,4,4,2,
2,7,0,0,0,3,0,0,0,7,6,3,6,1,1,0,1,0,2,1,0,0,0,0,0,0,7,2,
2,0,0,0,0,3,0,0,0,3,6,3,6,1,0,0,1,0,0,1,0,0,0,0,0,0,8,2,
2,3,0,0,0,3,0,0,0,3,6,3,6,1,0,7,1,9,0,1,0,0,0,0,0,0,1,2,
2,3,0,0,0,3,0,0,0,3,6,2,1,1,0,0,1,1,0,1,0,0,0,0,0,7,1,2,
2,3,2,2,2,2,5,1,2,2,6,2,0,0,0,0,0,1,0,1,0,0,0,0,0,1,1,2,
2,3,0,4,4,4,4,4,4,4,4,2,4,4,4,4,4,1,0,1,0,0,7,0,0,0,1,2,
2,3,0,0,0,0,0,7,0,0,3,0,0,0,0,0,1,1,0,1,0,0,0,0,1,1,1,2,
2,3,0,0,3,2,5,2,2,2,3,2,2,2,1,3,1,0,0,1,0,0,0,7,1,0,0,2,
2,3,0,0,3,2,0,0,0,2,3,2,0,0,1,3,1,1,1,1,5,1,2,1,0,7,0,2,
2,3,0,0,3,2,0,0,0,2,3,2,7,0,1,3,0,0,0,0,0,0,0,0,1,1,2,2,
2,3,0,7,3,2,0,8,0,2,3,2,1,1,1,1,1,2,2,1,1,1,2,1,1,1,1,2,
