6,0,0,0,0,0,0,0,0,0,0,0,0,1,1,0,0,0,0,0,0,0,0,0,0,0,0,6,
6,0,0,0,0,0,0,0,0,0,0,0,0,2,2,0,0,0,0,0,0,0,0,0,0,0,0,6,
6,0,7,0,0,0,0,0,0,0,7,0,0,1,1,0,0,7,0,0,0,0,0,0,0,7,0,6,
2,1,2,1,2,1,2,1,2,1,2,1,3,2,2,3,1,2,1,2,1,2,1,2,1,2,1,2,
0,0,0,7,0,0,0,0,0,7,0,0,3,1,1,3,0,0,7,0,0,0,0,0,7,0,0,0,
3,2,1,2,1,2,1,2,1,2,1,2,1,2,2,1,2,1,2,1,2,1,2,1,2,1,2,3,
3,0,0,0,7,0,0,0,7,0,0,0,0,1,1,0,0,0,0,7,0,0,0,7,0,0,0,3,
2,1,2,1,2,1,2,1,2,1,2,1,3,2,2,3,1,2,1,2,1,2,1,2,1,2,1,2,
0,0,0,0,7,8,0,8,7,0,0,0,3,1,1,3,0,0,0,7,8,0,8,7,0,0,0,0,
3,2,1,2,1,2,1,2,1,2,1,2,1,2,2,1,2,1,2,1,2,1,2,1,2,1,2,3,
3,0,0,7,0,0,0,0,0,7,0,0,0,1,1,0,0,0,7,0,0,0,0,0,7,0,0,3,
2,1,2,1,2,1,2,1,2,1,2,1,3,2,2,3,1,2,1,2,1,2,1,2,1,2,1,2,
0,0,7,0,0,0,0,0,0,0,7,0,3,1,1,3,0,7,0,0,0,0,0,0,0,7,0,0,
3,2,1,2,1,2,1,2,1,2,1,2,1,2,2,1,2,1,2,1,2,1,2,1,2,1,2,3,
3,0,0,0,0,0,0,0,0,0,0,0,0,9,0,0,0,0,0,0,0,0,0,0,0,0,0,3,
1,2,1,2,1,2,1,2,1,2,1,2,1,2,1,2,1,2,1,2,1,2,1,2,1,2,1,2,
