3,3,0,1,1,1,1,1,8,3,2,2,2,0,2,2,2,3,8,1,1,1,1,1,0,3,3,2,
3,2,3,3,0,7,0,3,3,2,3,3,3,3,3,3,3,2,3,3,0,7,0,3,3,2,3,3,
7,3,2,3,1,3,1,3,2,3,7,1,1,3,1,1,7,3,2,3,1,3,1,3,2,3,7,1,
1,0,3,2,3,3,3,2,3,0,1,0,3,3,3,0,1,0,3,2,3,3,3,2,3,0,1,3,
0,1,3,3,2,3,2,3,3,1,0,3,0,0,0,3,0,1,3,3,2,3,2,3,3,1,0,0,
3,1,0,3,3,3,3,3,0,1,3,0,1,1,1,0,3,1,0,3,3,3,3,3,0,1,3,1,
3,1,3,0,0,0,0,0,3,1,3,1,0,7,0,1,3,1,3,0,0,0,0,0,3,1,3,9,
3,1,0,3,3,3,3,3,0,1,3,0,1,1,1,0,3,1,0,3,3,3,3,3,0,1,3,1,
0,1,3,3,2,3,2,3,3,1,0,3,0,0,0,3,0,1,3,3,2,3,2,3,3,1,0,0,
5,0,3,2,3,3,3,2,3,0,1,0,3,3,3,0,1,0,3,2,3,3,3,2,3,0,1,3,
7,3,2,3,1,3,1,3,2,3,7,1,1,3,1,1,7,3,2,3,1,3,1,3,2,3,7,1,
3,2,3,3,0,7,0,3,3,2,3,3,3,3,3,3,3,2,3,3,0,7,0,3,3,2,3,3,
2,3,0,1,1,1,1,1,0,3,2,2,2,3,2,2,2,3,0,1,1,1,1,1,0,3,2,2,
2,3,0,3,0,7,0,3,0,3,2,2,3,3,3,2,2,3,0,3,0,7,0,3,0,3,2,2,
2,3,0,3,1,3,1,3,8,3,3,2,3,3,3,2,3,3,8,3,1,3,1,3,0,3,2,2,
3,2,3,2,3,3,3,2,3,2,3,3,3,3,3,3,3,2,3,2,3,3,3,2,3,2,3,3,
