0,4,4,4,4,4,4,4,4,7,7,1,1,1,1,1,1,7,7,4,4,4,4,4,4,4,4,0,
3,0,0,0,0,0,0,0,7,1,1,1,3,3,3,3,1,1,1,7,0,0,0,0,0,0,0,3,
3,0,0,0,0,0,0,7,1,1,3,3,3,8,8,3,3,3,1,1,7,0,0,0,0,0,0,3,
3,0,0,0,0,0,0,1,1,3,3,0,0,0,0,0,0,3,3,1,1,0,0,0,0,0,0,3,
3,0,0,0,0,0,7,1,3,3,0,0,0,0,0,0,0,0,3,3,1,7,0,0,0,0,0,3,
3,0,0,0,0,0,1,1,3,7,0,0,0,0,0,0,0,0,7,3,1,1,0,0,0,0,0,3,
3,0,0,0,0,0,1,3,3,7,0,0,0,0,0,0,0,0,7,3,3,1,0,0,0,0,0,3,
3,0,0,0,0,0,1,3,7,7,0,0,0,0,0,0,0,0,7,7,3,1,0,0,0,0,0,3,
3,0,0,0,0,0,1,3,3,7,0,0,0,0,0,0,0,0,7,3,3,1,0,0,0,0,0,3,
3,0,0,0,0,0,1,1,3,7,0,0,0,0,0,0,0,0,7,3,1,1,0,0,0,0,0,3,
3,0,0,0,0,0,0,1,3,3,7,0,0,0,0,0,0,7,3,3,1,0,0,0,0,0,0,3,
3,0,0,0,0,0,0,1,5,3,3,7,7,0,0,7,7,3,3,5,1,0,0,0,0,0,0,3,
3,0,0,0,0,0,0,0,5,1,3,3,3,7,7,3,3,3,1,5,0,0,0,0,0,0,0,3,
3,0,0,0,0,0,0,0,0,1,1,1,3,3,3,3,1,1,1,0,0,0,0,0,0,0,0,3,
3,9,0,0,0,0,0,0,8,0,0,1,1,1,1,1,1,0,0,8,0,0,0,0,0,0,0,3,
1,1,1,1,1,1,1,1,1,3,0,0,0,0,0,0,0,0,3,1,1,1,1,1,1,1,1,1,
