0,0,0,0,0,0,8,0,0,0,6,0,0,0,0,0,0,0,6,0,0,0,8,0,0,0,0,0,
0,0,0,0,0,0,0,0,0,0,0,6,0,0,0,0,0,6,0,0,0,0,0,0,0,0,0,0,
0,0,0,0,0,0,0,0,0,0,0,0,6,0,0,0,6,0,0,0,0,0,0,0,0,0,0,0,
0,0,0,0,0,0,0,0,0,0,7,1,1,1,3,1,1,1,7,0,0,0,0,0,0,0,0,0,
0,0,0,0,0,0,0,0,0,0,1,7,1,7,3,7,1,7,1,0,0,0,0,0,0,0,0,0,
0,0,7,0,0,0,0,0,0,1,7,3,0,3,1,3,0,3,7,1,0,0,0,0,7,0,7,0,
0,0,1,1,3,1,3,1,1,1,1,1,1,3,0,3,1,1,1,1,1,1,3,1,3,1,1,0,
0,7,1,0,3,1,3,0,0,0,0,0,0,3,3,3,0,0,0,0,0,0,3,1,3,7,1,0,
0,1,0,3,3,1,3,3,3,3,3,3,3,3,3,3,3,3,3,3,3,3,3,1,3,3,0,1,
0,1,3,8,7,0,1,3,3,3,3,3,3,3,1,3,3,3,3,3,3,3,1,0,7,8,3,1,
0,0,1,1,1,3,0,1,3,0,7,0,0,3,0,3,0,0,7,0,3,1,0,0,1,1,1,0,
0,0,0,7,1,1,3,1,1,1,1,1,1,1,3,1,1,1,1,1,1,1,3,1,1,7,0,0,
0,0,0,1,1,0,3,0,0,0,0,0,7,0,3,0,7,0,0,0,0,0,3,0,1,1,0,0,
0,0,0,1,0,3,1,1,3,3,3,3,3,3,1,3,3,3,3,3,3,1,1,3,0,1,0,0,
0,7,0,0,3,1,1,1,3,3,3,1,3,3,3,3,3,1,3,3,3,1,1,1,3,9,7,0,
1,1,1,1,1,1,1,1,1,1,1,1,1,1,1,1,1,1,1,1,1,1,1,1,1,1,1,1,
