1,1,1,1,1,1,1,1,1,1,1,1,0,0,0,0,1,1,1,1,1,1,2,2,1,1,1,6,
1,4,4,4,4,4,4,4,4,4,4,4,4,4,4,4,4,4,4,4,4,4,0,1,1,0,1,6,
1,0,3,1,1,1,1,1,1,1,1,1,3,0,0,6,1,4,4,4,4,4,3,4,4,4,4,6,
9,0,3,7,2,7,7,7,7,0,0,0,3,0,0,6,1,7,0,0,7,7,3,0,0,0,7,6,
1,1,3,1,1,1,1,1,2,1,1,1,3,0,0,6,1,1,1,3,1,1,1,5,1,3,1,6,
1,0,3,3,3,3,3,0,2,0,0,7,3,0,0,6,1,7,0,3,4,4,4,4,4,3,0,6,
1,7,0,0,2,7,3,0,0,7,7,1,3,0,0,6,1,2,0,3,0,2,2,2,0,3,7,6,
1,1,1,1,1,1,1,5,1,1,1,1,3,0,0,6,1,7,0,3,8,0,0,7,7,3,2,3,
1,0,0,7,2,7,7,0,2,0,0,1,3,0,0,6,1,1,1,1,1,1,3,1,1,1,1,3,
1,0,0,2,2,2,2,0,2,0,0,1,3,4,4,3,1,7,0,0,0,0,3,0,0,7,7,6,
1,0,7,7,7,0,7,7,2,7,0,1,3,7,8,3,1,2,7,0,0,0,3,0,1,1,1,3,
1,3,1,1,1,5,1,1,1,1,3,1,1,1,1,1,1,1,1,1,3,1,1,1,1,1,1,3,
1,3,4,4,4,4,4,4,4,4,3,1,1,1,0,4,4,4,4,4,3,4,2,0,4,4,4,3,
1,3,0,7,0,0,7,7,7,0,3,0,0,7,3,0,7,0,7,0,3,0,2,3,7,0,7,1,
1,1,3,1,1,3,2,1,3,1,1,1,5,1,3,1,1,2,1,5,1,1,1,1,1,3,1,1,
0,7,3,7,7,3,8,0,3,0,0,0,0,0,3,0,0,0,0,0,0,0,0,7,7,3,7,7,
