0,0,0,0,0,0,0,0,0,0,0,0,0,0,0,0,0,0,0,0,0,0,0,0,0,0,0,0,
0,0,0,0,0,0,0,0,0,3,1,1,0,0,0,0,1,1,3,0,0,0,0,0,0,0,0,0,
0,0,0,0,0,0,0,0,3,1,1,0,0,0,0,0,0,1,1,3,0,0,0,0,0,0,0,0,
0,0,0,0,0,0,0,3,1,1,0,0,0,0,0,0,0,0,1,1,3,0,0,0,0,0,0,0,
0,0,0,0,0,0,3,1,1,7,0,0,8,0,0,0,0,0,7,1,1,3,0,0,0,0,0,0,
0,0,7,4,4,3,1,1,1,1,1,1,1,1,1,1,1,1,1,1,1,1,3,4,4,7,8,0,
0,3,1,3,0,0,0,1,1,7,0,0,0,0,0,0,0,0,7,1,1,0,0,0,3,1,3,0,
0,3,3,1,3,0,0,0,1,1,0,7,0,0,0,0,7,0,1,1,0,0,0,3,1,3,3,0,
0,7,3,3,1,3,0,0,0,1,1,1,1,0,0,1,1,1,1,0,0,0,3,1,3,3,7,0,
0,0,7,3,3,1,3,0,0,0,1,1,1,0,0,1,1,1,0,0,0,3,1,3,3,7,0,0,
0,0,0,7,3,3,1,3,0,0,0,1,1,7,9,1,1,0,0,0,3,1,3,3,7,0,0,0,
0,0,0,0,7,3,3,1,3,0,0,0,1,1,1,1,0,0,0,3,1,3,3,7,0,0,0,0,
0,0,0,0,0,7,3,3,1,3,0,0,0,3,3,0,0,0,3,1,3,3,7,0,0,0,0,0,
0,0,0,0,0,0,7,3,3,1,3,0,0,3,3,0,0,3,1,3,3,7,0,0,0,0,0,0,
7,0,0,8,0,0,0,7,3,1,1,3,0,3,3,0,3,1,1,3,7,0,0,0,8,0,0,7,
1,1,1,1,1,1,1,1,1,1,1,1,1,1,1,1,1,1,1,1,1,1,1,1,1,1,1,1,
