6,0,0,0,0,0,0,0,0,0,0,1,1,1,1,1,1,1,1,1,1,1,1,1,1,1,1,1,
6,0,0,0,0,0,0,0,0,0,0,1,1,1,1,1,1,1,1,2,0,4,4,4,4,4,4,1,
6,0,0,0,0,7,0,0,0,3,1,0,0,0,0,7,0,0,0,2,3,0,1,0,7,0,0,1,
1,1,1,1,1,1,1,1,1,3,2,1,1,1,1,1,1,1,0,2,3,0,1,1,1,1,1,1,
0,0,0,0,7,0,0,0,0,3,2,0,0,0,0,7,0,0,0,2,3,0,1,1,1,1,1,1,
3,1,1,1,1,1,1,1,1,1,2,0,1,1,5,1,1,1,0,2,3,0,1,1,1,1,1,1,
3,0,0,0,0,8,7,0,0,0,2,0,0,0,0,0,0,7,0,2,3,0,0,0,8,0,0,0,
1,1,1,1,1,1,1,1,1,3,2,0,1,1,5,5,5,1,0,1,1,1,1,1,1,1,1,3,
0,7,0,0,0,0,0,0,0,3,2,0,0,0,0,7,0,0,0,0,0,0,0,0,0,0,0,3,
3,1,1,1,1,1,1,1,1,1,2,0,1,1,5,1,1,1,0,0,0,0,0,0,0,0,0,3,
3,0,0,7,0,0,0,0,0,0,2,0,0,0,0,0,0,7,0,0,0,0,0,0,0,0,0,3,
1,1,1,1,1,1,1,1,1,3,2,0,1,1,5,5,5,1,0,0,1,1,1,1,1,0,0,3,
0,0,0,0,0,0,0,0,7,3,2,0,0,0,0,0,0,7,0,0,1,0,0,7,1,0,0,3,
3,1,1,1,1,1,1,1,1,1,2,0,1,1,5,1,1,1,0,0,0,0,3,1,1,0,0,3,
3,0,0,0,8,0,0,0,0,0,0,0,9,0,0,0,0,0,0,0,0,0,3,1,0,7,0,3,
1,1,1,1,1,1,1,1,1,1,1,1,1,1,1,1,1,1,1,1,1,1,1,1,1,1,1,1,
