0,0,0,0,0,0,0,0,0,0,6,0,0,0,0,0,0,0,0,0,0,0,0,0,0,0,0,0,
0,0,0,0,0,0,0,0,0,0,6,0,0,0,0,0,0,0,0,0,0,0,0,0,0,0,0,0,
0,7,0,8,0,7,0,0,0,2,3,2,0,0,0,4,4,4,4,4,4,4,4,0,9,0,0,0,
3,2,1,1,1,2,2,1,0,2,3,7,0,0,0,0,0,0,0,0,0,0,1,1,1,1,0,0,
3,2,0,0,0,0,0,0,0,2,3,2,0,0,0,0,7,0,0,0,0,0,0,0,0,0,0,7,
3,2,4,4,4,4,0,0,0,2,3,2,0,0,1,1,1,1,4,4,4,0,0,0,0,0,0,3,
3,2,0,0,0,0,0,0,7,2,3,2,0,0,7,0,0,0,0,0,0,0,0,0,7,0,0,3,
3,0,0,7,2,1,1,1,2,2,3,2,1,1,1,0,0,0,0,0,0,3,1,1,1,1,0,3,
3,2,1,2,2,0,0,0,0,2,3,2,0,0,0,0,0,0,8,7,0,3,1,0,0,0,0,3,
3,2,4,4,4,4,4,4,4,0,3,2,0,0,0,1,1,1,1,1,1,1,1,0,0,0,0,3,
3,2,0,0,0,0,7,0,0,2,3,2,0,0,0,7,0,0,0,0,0,0,0,0,7,0,0,3,
3,2,0,0,0,2,1,1,1,2,3,2,4,4,1,1,1,1,4,4,0,0,3,1,1,0,0,3,
3,2,7,0,0,0,0,0,0,2,3,2,0,0,0,0,0,0,0,0,7,0,3,0,0,0,0,3,
3,2,1,1,0,0,0,0,0,2,3,2,0,0,0,0,0,0,1,1,1,1,1,0,0,0,0,3,
3,0,0,0,0,0,8,0,0,0,3,0,0,0,0,0,0,0,0,0,0,0,0,0,0,0,0,3,
2,1,1,1,2,1,1,1,1,2,2,2,2,1,1,1,2,1,1,1,1,2,2,1,1,2,2,2,
