1,1,1,1,1,1,1,1,1,1,1,1,1,1,1,0,0,0,0,0,0,0,0,0,0,0,0,6,
1,0,0,0,0,0,0,0,0,0,0,0,0,0,1,0,0,0,0,0,0,0,0,0,0,0,0,6,
1,0,4,4,4,4,4,4,4,4,4,4,4,4,3,3,1,1,1,1,1,1,1,7,0,0,0,6,
1,0,0,0,0,0,0,0,0,0,0,0,0,0,3,1,0,0,7,0,0,1,0,1,4,4,4,3,
1,7,0,7,8,0,0,0,0,0,0,9,0,0,3,1,0,0,0,0,0,1,0,1,8,0,0,3,
1,3,1,1,1,1,1,1,3,2,2,2,2,2,2,1,2,2,0,0,0,3,0,0,1,1,0,3,
1,3,0,0,0,0,0,1,3,0,0,0,0,0,0,1,1,1,0,0,0,3,0,0,0,0,0,3,
1,3,7,0,0,0,0,1,3,4,4,4,4,4,4,4,0,0,0,8,0,1,3,0,0,0,0,3,
1,3,0,0,0,1,1,2,3,0,0,0,0,0,0,1,1,1,1,1,1,1,3,0,0,0,3,1,
1,3,0,0,1,1,7,2,3,0,0,0,0,1,1,1,0,0,0,0,0,1,3,1,1,1,1,1,
1,3,0,0,1,0,0,2,3,0,0,7,1,1,7,1,0,7,7,0,0,1,3,1,1,0,1,1,
1,3,1,1,0,0,0,2,3,0,0,1,1,0,0,1,1,1,1,1,1,1,3,1,0,1,0,1,
1,3,1,7,0,0,0,2,3,0,1,1,0,0,0,1,4,4,4,4,4,1,3,1,1,0,1,1,
1,3,0,0,0,0,0,3,3,3,1,0,0,0,0,1,0,0,7,0,0,1,3,1,7,1,0,1,
1,3,0,0,0,0,0,3,1,3,0,0,0,0,0,0,0,0,0,0,0,1,3,1,1,0,1,1,
1,1,1,1,1,1,1,1,1,1,1,1,1,1,1,1,1,1,1,1,1,1,1,1,1,1,1,1,
