0,0,0,0,0,0,0,0,0,0,0,0,0,0,0,0,0,0,0,0,0,0,0,0,0,6,0,0,
0,0,0,0,0,0,0,0,0,0,0,0,0,0,0,0,0,0,0,0,9,0,0,0,0,0,6,0,
0,0,0,5,1,1,1,1,3,3,1,1,1,1,1,1,3,3,3,3,3,0,0,0,0,0,0,6,
0,0,0,0,0,0,0,0,0,3,0,0,0,1,0,0,3,0,0,0,0,0,0,0,0,0,6,0,
0,0,0,0,7,0,0,0,0,0,3,0,3,1,0,0,3,0,0,0,0,0,0,0,0,6,0,0,
0,0,0,0,1,7,0,0,0,0,0,3,3,1,0,0,3,0,0,0,0,0,0,0,6,0,0,0,
0,0,0,1,1,1,7,0,0,0,0,0,3,1,0,0,3,0,0,0,0,0,0,6,0,0,0,0,
0,0,1,1,1,1,1,7,0,0,0,0,3,1,0,0,3,0,0,0,0,0,6,0,0,0,0,0,
1,1,1,1,1,1,1,1,0,0,0,0,3,1,0,0,3,0,0,0,0,0,0,6,0,0,0,0,
0,7,1,1,1,1,1,0,0,0,0,0,3,1,0,0,3,0,0,0,0,0,0,0,6,0,0,0,
0,0,0,1,1,1,0,0,0,0,0,0,3,1,0,0,3,0,0,0,0,0,0,0,0,6,0,0,
0,0,0,0,1,0,0,0,0,0,0,0,3,1,0,0,3,0,0,0,0,0,0,0,0,0,6,0,
0,0,0,0,0,0,0,8,0,0,0,0,3,1,0,0,3,0,0,0,8,0,0,0,0,0,0,6,
0,3,1,1,1,1,1,1,1,1,1,1,1,1,1,1,5,1,1,1,1,1,1,1,1,1,0,6,
0,1,1,1,1,1,1,1,1,1,1,1,1,1,1,1,0,0,0,0,0,0,0,0,0,3,1,6,
1,1,1,1,1,1,1,1,1,1,1,1,1,1,1,1,0,0,0,7,7,7,7,7,7,3,1,1,
