2,2,2,2,2,2,2,2,2,2,2,2,6,0,0,2,2,2,0,0,0,0,0,0,0,2,1,2,
1,1,1,1,1,1,1,2,1,1,2,2,6,0,0,1,1,2,0,0,0,0,0,0,0,1,2,1,
0,0,0,7,0,0,1,2,1,2,1,2,6,0,0,2,1,2,0,0,0,0,0,0,0,1,0,0,
3,2,1,1,1,5,1,0,0,0,0,2,6,0,8,0,1,2,0,0,0,0,0,0,7,1,0,7,
3,1,1,1,1,0,0,0,4,4,4,4,3,1,1,2,1,2,5,1,1,1,1,1,3,2,0,3,
3,1,0,7,1,0,4,4,4,2,1,2,3,1,0,0,0,0,5,2,1,1,1,1,3,1,0,3,
3,1,1,1,4,4,4,0,0,2,1,2,3,1,4,4,4,4,5,2,1,1,1,1,3,2,1,3,
3,1,1,4,4,4,0,0,0,0,0,0,3,2,0,0,0,0,0,7,0,1,1,2,3,1,1,3,
3,1,4,4,7,0,0,0,1,1,2,1,3,1,0,0,0,0,5,1,1,2,2,1,3,1,1,3,
3,4,4,0,2,4,4,4,4,4,4,4,3,0,0,0,4,4,4,4,4,0,1,1,3,0,1,3,
0,0,0,2,1,8,0,0,7,0,0,2,3,5,1,1,2,0,9,0,7,0,0,0,3,1,1,3,
1,1,5,1,2,1,1,0,2,1,1,2,3,5,1,1,2,2,1,2,2,1,2,0,0,0,0,3,
1,1,5,1,2,0,0,0,0,0,0,2,3,5,0,0,0,0,8,0,7,0,2,1,1,1,1,1,
1,1,5,1,2,4,4,4,4,4,4,4,3,5,1,1,0,0,1,1,1,1,2,0,0,7,0,1,
1,1,0,0,0,0,0,7,0,0,0,2,3,0,0,0,0,0,0,0,0,0,0,1,1,1,1,1,
1,2,1,1,1,1,2,1,1,3,0,0,3,0,0,3,1,1,1,2,1,1,1,1,1,1,1,1,
