0,0,0,0,0,0,0,0,0,0,0,0,0,6,0,0,0,0,0,0,0,0,0,0,0,0,0,0,
0,0,0,0,0,0,0,0,0,0,0,0,0,6,0,0,0,0,0,0,0,0,0,0,0,0,0,0,
7,0,0,0,0,0,0,0,0,0,0,0,0,6,6,0,0,0,0,0,0,0,0,0,0,0,0,7,
1,3,0,3,4,4,4,4,4,4,4,4,4,4,6,4,4,4,4,4,4,4,4,4,3,0,3,1,
1,1,3,3,0,8,0,0,0,0,0,0,0,0,0,0,0,0,0,0,0,0,7,0,3,3,1,1,
1,1,1,3,0,3,4,4,4,4,4,4,0,4,4,4,4,4,4,4,4,4,3,0,3,1,1,1,
1,1,1,1,3,3,0,7,0,0,0,0,0,0,0,0,0,0,0,0,0,0,3,3,1,1,1,1,
1,1,1,1,5,3,0,3,4,4,4,4,4,4,0,4,4,4,4,4,3,8,3,5,1,1,1,1,
1,1,1,1,5,1,3,3,0,0,0,0,0,0,0,0,0,0,7,0,3,3,1,5,1,1,1,1,
1,1,1,1,5,1,1,3,0,3,4,4,4,0,4,4,4,4,3,0,3,1,1,5,1,1,1,1,
1,1,1,1,5,1,1,1,3,3,0,7,0,0,0,0,0,0,3,3,1,1,1,5,1,1,1,1,
1,1,1,1,5,1,1,1,1,3,0,3,4,4,0,4,3,0,3,1,1,1,1,5,1,1,1,1,
1,1,1,1,5,1,1,1,1,1,3,3,0,0,0,0,3,3,1,1,1,1,1,5,1,1,1,1,
1,1,1,1,5,1,1,1,1,1,1,3,0,0,0,0,3,1,1,1,1,1,1,5,1,1,1,1,
1,1,1,1,5,1,1,1,1,1,1,1,3,9,7,3,1,1,1,1,1,1,1,5,1,1,1,1,
1,1,1,1,8,0,0,0,0,0,0,0,3,1,1,3,0,0,0,0,0,0,0,0,1,1,1,1,
