2,0,0,0,0,0,0,0,0,0,0,0,0,0,0,0,2,2,2,2,2,2,2,2,2,2,2,6,
2,8,0,0,0,0,0,0,0,0,8,0,0,0,0,0,2,0,0,7,0,2,0,0,0,0,0,6,
2,2,4,4,4,4,4,4,1,1,1,1,1,3,0,9,2,0,3,2,0,2,3,2,1,1,1,6,
2,1,1,1,1,1,0,0,0,7,0,0,1,1,1,2,2,0,3,2,0,2,3,2,1,1,1,6,
2,0,0,0,0,1,1,1,1,1,1,0,0,0,0,0,0,0,3,2,0,2,3,2,0,0,0,6,
1,1,1,3,0,0,0,0,0,0,1,1,1,1,3,0,7,0,3,2,0,2,3,2,0,7,0,6,
1,0,1,1,1,2,1,3,0,0,0,0,0,0,3,1,1,1,2,2,0,2,3,2,1,1,1,6,
1,0,0,7,0,0,1,1,2,1,3,0,0,0,3,0,0,0,0,2,0,2,3,2,1,1,1,6,
1,1,1,1,1,0,0,0,0,0,1,1,2,1,3,0,0,0,0,2,0,2,3,2,0,0,0,6,
1,0,7,0,1,2,3,1,0,8,0,0,0,1,1,2,1,1,3,2,0,2,3,2,7,7,0,6,
1,1,1,0,0,0,3,1,1,2,2,1,0,0,7,0,0,2,3,2,0,2,3,2,1,1,1,6,
1,0,1,2,1,1,3,0,0,0,0,1,1,1,2,2,1,2,3,2,0,2,3,2,1,1,1,6,
1,0,0,0,1,1,1,2,1,1,3,0,0,7,0,0,0,2,3,2,0,2,3,2,0,1,1,6,
1,0,3,1,1,0,0,0,7,1,1,1,2,2,1,3,1,2,3,2,0,2,3,2,0,0,1,6,
1,0,3,1,0,0,0,0,0,0,0,0,0,0,0,3,0,7,3,2,0,0,3,0,0,0,7,6,
1,7,3,1,2,1,1,1,1,2,1,1,1,1,1,2,1,1,2,2,1,1,2,1,1,1,1,1,
