0,0,0,0,0,0,0,0,0,0,0,0,0,0,0,0,0,0,8,0,0,0,0,0,0,0,0,0,
1,1,1,1,1,1,1,1,1,1,1,1,1,1,1,1,1,1,1,1,1,1,1,1,1,1,1,6,
7,0,8,0,0,0,0,0,1,0,0,0,0,0,0,0,7,0,0,1,0,7,0,0,0,0,0,6,
1,1,1,3,1,0,1,3,1,3,1,1,1,1,1,1,1,1,0,1,3,1,0,1,1,3,1,1,
1,1,1,3,1,3,1,3,1,3,1,0,0,7,0,0,0,1,0,1,3,1,0,1,1,3,1,1,
1,1,1,3,1,3,1,0,1,3,1,0,1,1,1,1,0,1,0,1,3,1,0,0,0,3,0,3,
1,7,1,3,1,3,1,3,1,3,1,3,1,0,0,1,0,1,0,1,3,1,0,1,1,1,1,3,
1,0,0,3,1,3,1,3,1,3,1,3,1,1,0,1,0,1,0,1,3,1,0,1,3,0,0,3,
0,3,1,3,1,3,1,3,1,3,1,3,0,0,7,1,0,1,0,1,3,1,0,1,3,1,1,1,
3,1,1,1,0,3,1,3,1,3,1,1,1,1,1,1,0,1,0,1,3,1,0,1,3,0,0,3,
3,1,1,0,1,3,1,3,1,3,0,7,0,0,0,0,0,1,0,1,3,0,4,1,1,1,1,3,
3,0,0,4,1,3,1,3,1,1,1,1,1,1,1,1,1,1,0,1,3,1,0,1,3,0,0,3,
3,1,1,0,1,3,1,3,0,0,0,0,0,0,0,0,0,0,0,1,3,1,0,1,3,1,1,3,
4,4,1,0,1,3,1,1,1,1,1,1,1,1,1,1,1,1,1,1,3,1,0,1,3,0,0,3,
0,0,0,0,0,3,0,0,0,0,0,0,8,0,0,0,0,0,0,0,3,1,0,1,1,1,1,3,
1,1,1,1,1,1,1,1,1,1,1,1,1,1,1,1,1,1,1,1,1,1,0,8,0,0,0,3,
