0,4,4,4,4,4,4,4,4,4,0,1,1,1,1,1,1,0,0,4,4,4,4,4,4,4,4,0,
3,0,0,0,0,0,0,0,0,1,1,1,0,0,0,0,1,1,1,0,0,0,0,0,0,0,0,3,
3,0,0,0,0,0,0,0,1,1,0,0,0,1,3,1,0,0,0,1,0,0,0,0,0,0,0,3,
3,0,0,0,0,0,0,1,1,1,1,1,1,1,3,1,1,1,1,1,1,0,0,0,0,0,0,3,
3,0,0,0,0,0,0,1,4,4,1,1,1,1,3,1,1,1,1,1,1,0,0,0,0,0,0,3,
3,0,0,0,0,0,1,0,0,0,1,0,0,1,3,1,1,1,0,1,1,1,0,0,0,0,0,3,
3,0,0,0,0,0,1,8,0,0,0,0,0,1,3,1,1,1,0,1,3,1,0,0,0,0,0,3,
3,0,0,0,0,0,1,1,3,1,3,7,0,1,3,1,1,1,0,7,3,1,0,0,0,0,0,3,
3,0,0,0,0,0,1,0,3,1,1,1,1,1,3,1,1,1,7,0,3,1,0,0,0,0,0,3,
3,0,0,0,0,0,1,1,0,0,0,0,0,1,3,1,1,1,1,1,1,1,0,0,0,0,0,3,
3,0,0,0,0,0,0,1,1,0,0,0,0,0,3,0,0,0,0,0,1,0,0,0,0,0,0,3,
3,0,0,0,0,0,0,1,1,0,1,0,0,0,0,0,1,2,1,2,1,0,0,0,0,0,0,3,
3,0,0,0,0,0,0,0,5,0,1,0,0,0,0,0,0,0,1,5,0,0,0,0,0,0,0,3,
3,0,0,0,0,0,0,0,0,1,1,1,0,0,0,0,1,1,1,0,0,0,0,0,0,0,0,3,
3,9,0,0,0,0,0,0,0,0,0,1,1,1,1,1,1,0,0,0,0,0,0,0,0,0,0,3,
1,1,1,1,1,1,1,1,1,1,0,0,0,0,0,0,0,0,0,1,1,1,1,1,1,1,1,1,
