2,6,0,0,0,0,0,0,0,0,0,0,0,0,0,0,0,0,0,0,0,0,0,0,0,0,0,2,
2,6,2,2,2,2,0,2,2,2,2,2,2,2,2,2,1,2,2,2,2,2,2,2,2,2,0,2,
2,6,0,0,0,0,7,0,0,0,7,4,4,4,4,0,0,0,4,4,4,4,4,4,4,4,3,2,
2,6,0,0,0,0,0,0,0,3,1,1,0,0,1,1,1,1,1,0,0,0,0,0,1,1,3,2,
2,6,0,0,0,0,0,7,0,3,0,0,0,0,0,0,0,7,1,0,0,1,0,7,1,7,3,2,
2,6,0,0,0,0,1,1,1,3,0,0,7,0,9,0,0,1,1,0,0,1,5,1,1,2,3,2,
2,6,0,7,0,0,0,0,0,3,1,1,1,1,1,3,0,0,1,0,8,0,0,0,0,0,3,2,
2,6,0,1,1,1,0,0,0,3,1,0,0,0,1,3,0,0,1,4,4,4,3,1,1,1,1,2,
2,6,0,0,0,0,0,8,0,3,1,7,0,0,1,3,0,0,1,0,0,0,3,4,4,4,0,2,
2,6,0,0,0,3,1,1,1,1,1,1,1,1,1,3,1,1,1,0,0,0,3,0,0,7,0,2,
2,1,1,1,0,3,1,7,0,1,0,7,0,0,1,0,0,0,1,0,0,0,3,0,1,1,1,2,
2,7,0,1,1,3,1,1,1,1,1,1,1,1,1,0,0,0,1,0,0,0,3,0,1,0,0,2,
2,1,1,1,1,3,4,4,4,7,7,2,7,7,1,7,0,0,1,1,2,2,2,3,2,1,1,2,
2,0,0,0,1,3,0,0,1,1,1,2,1,1,1,1,1,3,1,0,0,0,0,3,0,0,7,2,
2,0,7,0,1,3,0,0,0,0,7,0,0,0,0,0,0,3,3,0,0,8,0,3,1,3,0,2,
1,1,1,1,1,3,1,1,1,1,1,1,1,1,1,1,1,1,3,1,1,1,1,1,1,1,1,1,
