0,0,0,6,0,0,0,0,0,0,0,0,0,0,0,0,0,0,0,0,0,0,0,0,0,0,0,0,
0,0,0,6,0,0,0,0,0,0,7,0,0,0,0,0,0,0,0,0,7,0,0,0,0,0,0,7,
3,5,1,3,0,0,0,0,3,1,1,1,3,0,0,0,0,0,3,1,1,1,3,1,0,0,1,3,
3,0,0,1,1,1,1,1,1,0,0,0,3,1,1,1,1,1,3,0,0,0,3,0,0,7,0,3,
3,7,0,8,0,0,0,0,0,0,0,0,3,0,0,0,0,0,3,0,0,0,1,1,1,1,0,3,
3,5,1,1,1,1,0,0,0,0,0,0,0,0,0,1,1,1,3,1,0,0,0,0,0,0,0,3,
3,0,2,1,1,1,1,0,0,0,0,0,0,0,1,1,0,0,0,0,0,0,0,0,3,1,0,3,
3,0,2,1,1,1,1,1,0,0,0,0,0,1,1,0,0,0,0,0,0,0,3,1,3,0,0,3,
3,0,2,1,1,1,1,1,1,1,1,1,1,1,0,0,0,0,7,0,0,0,3,0,0,0,1,1,
3,0,2,1,1,1,1,1,1,1,1,1,1,1,0,0,0,1,1,1,0,0,3,0,0,0,0,0,
3,0,2,0,0,0,0,1,1,1,0,1,1,1,0,0,0,0,0,0,0,0,3,0,0,0,8,7,
3,0,2,0,0,7,0,1,1,0,7,0,1,1,0,0,0,0,0,8,0,0,3,0,0,0,1,1,
3,0,2,3,1,1,1,1,1,1,1,1,1,1,1,3,1,1,1,1,1,1,3,0,0,0,1,1,
3,0,0,3,0,0,0,0,0,0,0,0,0,0,0,3,0,0,0,0,0,0,3,0,0,0,1,1,
3,0,0,3,0,0,0,0,0,0,0,9,0,0,0,0,0,0,0,0,0,0,3,0,0,0,1,1,
1,1,1,1,1,1,1,1,1,1,1,1,1,1,1,1,1,1,1,1,1,1,1,1,1,1,1,1,
