0,0,0,0,0,0,0,0,0,0,0,0,0,0,0,0,0,0,0,0,0,0,0,0,0,0,0,0,
0,0,0,0,0,0,0,0,0,0,6,6,6,6,6,6,6,6,0,0,0,0,0,0,0,0,0,0,
0,0,0,0,0,0,0,0,0,0,3,1,1,1,1,1,1,3,0,0,0,0,0,0,0,0,0,0,
0,0,0,0,0,0,0,0,8,0,3,1,0,8,0,0,1,3,0,8,0,0,0,0,0,0,0,0,
0,0,0,0,0,0,0,0,0,0,3,1,0,0,7,0,1,3,0,0,0,0,0,0,0,0,0,0,
0,0,0,0,0,3,1,1,1,1,1,1,1,1,1,1,1,1,1,1,1,1,3,0,0,0,0,0,
0,0,0,0,0,3,1,0,0,0,0,1,0,0,0,0,1,0,0,0,0,1,3,0,0,0,0,0,
0,0,0,0,0,3,1,0,0,0,0,1,0,0,0,0,1,0,0,0,0,1,3,0,0,0,0,0,
0,0,0,0,0,3,1,0,0,0,0,1,0,0,0,0,1,0,0,0,0,1,3,0,0,0,0,0,
0,0,0,0,0,3,1,0,0,7,0,1,0,0,7,0,1,0,0,7,0,1,3,0,0,0,0,0,
3,1,1,1,1,1,1,1,1,1,1,1,1,1,5,1,1,1,1,1,1,1,1,1,1,1,1,3,
3,1,0,0,0,0,1,0,0,0,0,1,0,0,0,0,1,0,0,0,0,1,0,0,0,0,1,3,
3,1,0,0,0,0,1,0,0,0,0,1,0,0,0,0,1,0,0,0,0,1,0,0,0,0,1,3,
3,1,0,0,7,0,1,0,0,7,0,1,0,0,7,0,1,0,0,7,0,1,0,0,7,0,1,3,
3,1,3,1,1,3,1,3,1,1,3,1,3,1,1,3,1,3,1,1,3,1,3,1,1,3,1,3,
3,0,3,1,1,3,0,3,1,1,3,9,3,1,1,3,8,3,1,1,3,0,3,1,1,3,0,3,
