2,2,2,2,2,2,2,2,2,2,2,2,0,6,0,2,2,2,2,2,2,2,2,2,2,2,2,2,
2,4,4,4,4,4,4,4,4,3,1,2,4,6,4,2,1,3,4,4,4,4,4,4,4,4,4,2,
2,0,0,0,0,0,0,7,0,3,1,4,4,6,4,4,1,3,0,7,0,0,0,0,0,0,0,2,
2,0,0,0,7,0,0,1,1,3,4,4,7,6,7,4,4,3,1,1,0,0,7,0,0,0,0,2,
2,0,0,7,1,1,5,4,3,3,1,2,1,6,1,2,1,3,3,4,1,5,1,0,7,0,0,2,
2,0,7,1,1,4,4,3,4,1,5,4,3,6,3,4,5,1,4,3,4,4,1,1,1,7,0,2,
2,7,1,1,4,4,3,4,4,4,4,4,3,6,3,4,4,4,4,4,3,4,4,4,1,1,7,2,
1,5,4,4,4,3,4,4,4,4,4,4,3,6,3,4,4,4,4,4,4,3,4,4,4,4,5,1,
1,4,4,4,3,8,4,4,4,4,4,4,3,6,3,4,4,4,4,4,4,8,3,4,4,4,4,1,
1,0,0,0,3,1,1,1,1,1,1,5,3,9,3,5,1,1,1,1,1,1,3,0,0,0,0,1,
1,0,7,0,3,0,0,0,0,0,0,0,1,1,1,0,0,0,0,0,0,0,3,0,0,7,0,1,
3,0,0,0,3,0,0,0,0,8,0,0,1,7,1,0,0,8,0,0,0,0,3,0,0,0,0,3,
3,4,4,4,3,1,5,1,1,1,1,1,3,0,3,1,1,1,1,1,5,1,3,4,4,4,4,3,
3,0,7,0,0,3,0,0,0,0,0,0,3,0,3,0,0,0,0,0,0,3,0,0,7,0,0,3,
3,0,0,0,0,3,0,0,7,0,0,0,3,0,3,0,0,7,0,0,0,3,0,0,0,0,0,3,
1,1,1,1,1,1,1,1,1,2,1,1,1,1,1,1,1,2,1,1,1,1,1,1,2,2,2,2,
