0,0,0,0,0,0,0,0,0,0,0,0,0,0,0,0,0,0,0,0,0,2,2,2,2,2,2,3,
4,4,4,4,4,4,4,4,4,4,4,4,4,4,0,0,8,0,0,0,0,0,0,0,0,0,0,3,
3,0,0,0,0,0,0,0,0,0,0,0,0,3,2,2,2,2,2,2,2,0,3,1,0,3,6,1,
3,0,8,3,0,3,0,0,0,0,0,0,0,3,4,4,4,4,4,3,0,1,3,0,1,3,0,0,
2,2,2,2,2,3,2,3,2,0,9,0,0,0,0,0,0,0,0,3,0,0,1,1,1,6,1,5,
3,4,4,4,4,3,0,3,1,5,1,1,1,2,2,2,0,1,1,3,0,1,1,3,6,6,1,5,
3,0,0,0,0,3,0,3,1,0,7,1,0,0,0,7,0,0,0,3,0,1,0,3,1,4,4,5,
3,0,0,0,0,0,0,3,1,0,0,7,1,1,1,1,0,2,2,3,0,7,3,1,7,0,7,7,
3,0,0,0,0,0,0,3,1,0,8,1,1,1,1,1,0,0,0,3,0,1,3,1,0,0,0,1,
3,5,7,0,0,0,0,0,1,0,1,1,1,1,1,7,0,2,2,3,6,6,3,1,3,1,1,1,
3,0,1,0,0,0,0,0,1,0,7,1,1,1,1,1,0,7,0,3,0,0,1,0,3,1,1,0,
3,0,0,1,0,0,0,0,1,0,1,1,1,1,1,1,0,3,2,3,0,1,1,1,3,0,1,1,
3,0,0,0,1,0,0,0,1,3,0,7,1,7,0,1,0,3,0,3,0,0,1,0,3,1,0,7,
3,0,0,0,0,1,0,0,0,3,1,1,1,1,1,1,0,3,2,3,0,1,0,1,1,0,1,1,
3,0,0,0,0,0,0,0,1,0,0,0,0,0,0,0,0,0,0,3,0,0,0,0,0,0,0,0,
1,1,2,2,2,1,1,1,1,1,1,1,1,1,2,2,2,2,1,2,1,2,2,2,1,2,2,2,
