4,4,4,4,4,4,4,4,4,0,0,0,0,3,0,0,0,0,0,0,4,4,4,4,4,4,0,0,
0,0,0,0,0,0,0,0,0,3,0,0,0,0,3,0,0,0,0,3,0,0,0,0,0,0,0,0,
0,0,0,4,4,4,4,4,4,3,0,7,0,0,0,3,0,0,0,3,0,0,0,0,0,0,0,0,
0,0,3,0,7,0,8,0,0,1,1,1,0,0,0,3,0,0,0,0,3,0,0,0,0,0,0,0,
0,0,3,0,1,1,1,1,0,0,0,0,0,0,3,0,4,4,4,0,0,3,0,7,7,4,4,0,
0,0,3,0,0,0,0,0,0,0,0,0,0,3,0,0,0,7,0,0,0,3,0,2,2,0,0,0,
0,0,3,4,4,4,4,0,0,0,7,0,3,0,0,0,0,2,0,0,3,0,0,0,0,0,0,7,
0,0,0,0,0,0,0,3,0,1,1,0,3,0,0,0,0,0,0,3,0,0,0,0,0,0,0,1,
0,0,0,0,0,0,0,3,0,0,0,0,0,3,0,0,0,0,0,2,2,2,1,1,1,2,1,1,
0,0,0,0,0,0,0,3,0,0,0,0,0,0,3,0,4,4,0,0,0,0,0,0,0,0,0,0,
0,0,0,7,8,7,0,3,0,0,0,0,0,0,0,3,0,0,0,0,0,0,0,0,0,2,0,2,
0,0,1,1,1,1,0,3,4,4,4,4,0,0,0,3,0,0,0,2,2,2,2,2,2,2,0,2,
7,0,0,0,0,0,0,0,0,7,7,0,0,0,3,0,7,0,0,0,0,0,0,7,0,7,8,2,
2,0,0,0,0,0,0,0,0,2,2,0,0,3,0,0,1,0,0,1,1,1,1,1,1,1,1,1,
0,0,0,0,0,0,0,0,0,0,0,9,0,3,8,0,0,0,0,0,0,0,0,0,0,0,0,0,
1,1,1,1,1,2,2,2,1,1,1,1,1,1,1,1,1,2,2,2,1,1,1,1,1,1,1,1,
