0,0,0,0,4,4,7,0,4,4,4,4,4,4,4,4,8,4,4,4,4,4,0,4,4,4,4,4,
0,0,0,3,0,7,1,7,0,0,0,0,0,0,0,0,3,4,0,1,0,4,3,0,0,7,7,7,
7,9,3,0,7,1,0,1,7,0,0,0,0,0,0,3,4,0,1,1,1,0,4,3,0,0,7,7,
1,1,0,7,1,0,0,0,1,7,0,0,0,0,3,4,0,1,0,0,0,1,0,4,3,0,0,7,
0,8,0,5,0,0,1,0,0,1,0,0,0,3,4,0,1,1,0,0,0,1,1,0,4,3,0,8,
3,1,1,0,0,1,1,1,0,0,2,2,2,4,0,0,0,1,7,7,7,1,0,0,0,4,1,3,
3,0,0,0,1,0,0,0,1,0,0,0,7,0,0,0,3,3,1,1,1,0,0,0,0,0,0,3,
3,0,0,4,0,1,1,1,0,0,0,7,3,0,0,3,1,1,3,1,0,0,0,0,0,0,0,3,
3,0,0,0,4,0,1,0,0,0,7,3,0,0,0,3,7,7,3,0,4,4,4,4,4,4,4,3,
3,0,0,0,0,4,0,0,0,7,3,0,0,0,3,2,2,2,2,3,0,0,0,0,0,0,0,3,
2,2,2,3,0,0,4,4,4,3,0,0,0,0,3,7,0,0,7,3,0,4,4,4,4,4,4,3,
0,0,0,3,0,0,0,0,0,0,0,0,0,3,1,1,1,1,1,1,3,0,0,0,0,0,0,3,
1,1,1,3,1,1,1,3,0,0,0,0,0,3,7,0,0,0,0,7,3,0,4,4,4,4,4,3,
0,0,0,0,0,0,0,3,0,0,0,0,3,2,2,2,2,2,2,2,2,3,0,0,0,0,0,3,
0,0,0,0,0,0,0,3,0,0,8,0,3,7,0,0,0,8,0,0,7,3,0,4,4,4,4,3,
1,1,1,1,1,1,1,1,2,2,2,2,2,1,1,1,1,1,1,1,1,3,0,0,0,0,0,3,
