0,0,0,4,4,0,7,0,0,0,0,0,0,0,0,0,4,7,0,0,0,0,7,0,0,0,0,0,
0,0,3,0,0,1,1,0,0,0,0,0,0,0,0,3,0,1,1,0,0,0,1,1,3,0,0,0,
0,0,3,0,0,0,0,0,0,0,0,7,8,0,0,3,0,0,0,0,0,0,0,0,3,0,0,7,
0,7,3,4,4,0,0,0,0,0,0,1,1,0,7,3,0,0,8,7,0,0,0,0,3,3,1,1,
1,1,3,0,0,3,7,8,0,0,0,0,0,1,1,3,0,0,1,1,0,0,0,7,0,3,0,0,
0,0,0,7,0,3,1,1,0,0,0,0,0,0,0,3,0,0,0,0,0,0,1,1,0,3,0,0,
0,0,1,1,0,3,4,0,4,4,8,7,4,4,4,3,0,0,0,0,0,0,0,0,0,3,0,0,
0,0,7,0,0,0,0,3,0,0,1,1,0,0,0,0,7,0,0,0,7,4,0,0,0,3,7,0,
0,1,1,0,0,0,0,3,0,0,0,0,0,0,0,1,1,0,0,1,1,0,3,7,3,1,1,0,
0,0,0,0,4,0,7,3,0,0,7,0,0,0,0,0,0,0,0,0,0,0,3,1,1,0,0,0,
0,0,0,3,0,1,1,3,0,0,1,1,0,0,0,7,0,0,0,0,0,0,3,0,0,0,0,0,
0,7,0,3,0,0,0,0,0,7,0,0,0,0,1,1,0,7,0,0,0,0,3,7,0,0,0,0,
3,1,1,3,0,0,0,0,1,1,0,0,0,0,0,0,0,1,1,0,0,0,3,1,1,0,0,0,
3,0,0,0,0,0,0,0,0,0,0,0,0,0,0,0,0,0,0,0,0,0,0,0,0,0,0,0,
3,0,0,0,0,0,0,0,0,0,0,0,0,0,9,0,0,0,0,0,0,0,0,0,0,0,0,0,
1,1,1,1,1,1,1,1,1,1,1,1,1,1,1,1,1,1,1,1,1,1,1,1,1,1,1,1,
